Datum;Auftrag #;Transaktionen;Symbol;Name;ISIN;Anzahl;Stückpreis;Kosten;Aufgelaufene Zinsen;Nettobetrag;Währung Nettobetrag;Nettobetrag in der Währung des Kontos;Saldo;Währung
04-02-2021 18:15:01;81450525;Kauf;SOXL;DIREXION SEMICONDUCTOR BULL 3X;US25459W4583;300.0;554.97;599.74;0.00;-167'090.74;USD;-167'090.74;13'856.54;USD
03-02-2021 16:35:24;81366183;Kauf;SOXL;DIREXION SEMICONDUCTOR BULL 3X;US25459W4583;100.0;565.63;84.85;0.00;-56'647.85;USD;-56'647.85;180'947.28;USD
03-02-2021 16:35:24;81366183;Kauf;SOXL;DIREXION SEMICONDUCTOR BULL 3X;US25459W4583;100.0;565.88;84.88;0.00;-56'672.88;USD;-56'672.88;237'595.13;USD
03-02-2021 16:35:23;81366183;Kauf;SOXL;DIREXION SEMICONDUCTOR BULL 3X;US25459W4583;100.0;565.87;84.88;0.00;-56'671.88;USD;-56'671.88;294'268.01;USD
03-02-2021 16:35:23;81366183;Kauf;SOXL;DIREXION SEMICONDUCTOR BULL 3X;US25459W4583;100.0;565.87;84.88;0.00;-56'671.88;USD;-56'671.88;350'939.89;USD
03-02-2021 16:35:23;81366183;Kauf;SOXL;DIREXION SEMICONDUCTOR BULL 3X;US25459W4583;100.0;565.86;84.88;0.00;-56'670.88;USD;-56'670.88;407'611.77;USD
03-02-2021 16:35:23;81366183;Kauf;SOXL;DIREXION SEMICONDUCTOR BULL 3X;US25459W4583;100.0;565.81;84.87;0.00;-56'665.87;USD;-56'665.87;464'282.65;USD
03-02-2021 16:35:23;81366183;Kauf;SOXL;DIREXION SEMICONDUCTOR BULL 3X;US25459W4583;100.0;565.80;84.87;0.00;-56'664.87;USD;-56'664.87;520'948.52;USD
03-02-2021 16:35:23;81366183;Kauf;SOXL;DIREXION SEMICONDUCTOR BULL 3X;US25459W4583;100.0;565.71;164.86;0.00;-56'735.86;USD;-56'735.86;577'613.39;USD
03-02-2021 16:35:23;81366183;Kauf;SOXL;DIREXION SEMICONDUCTOR BULL 3X;US25459W4583;50.0;565.70;132.43;0.00;-28'417.43;USD;-28'417.43;634'349.25;USD
03-02-2021 16:35:22;81366183;Kauf;SOXL;DIREXION SEMICONDUCTOR BULL 3X;US25459W4583;50.0;565.62;42.42;0.00;-28'323.42;USD;-28'323.42;662'766.68;USD
03-02-2021 16:35:22;81366183;Kauf;SOXL;DIREXION SEMICONDUCTOR BULL 3X;US25459W4583;100.0;565.55;264.83;0.00;-56'819.83;USD;-56'819.83;691'090.10;USD
01-02-2021 17:02:05;81213035;Verkauf;SOXL;DIREXION SEMICONDUCTOR BULL 3X;US25459W4583;900.0;522.70;716.05;0.00;469'713.95;USD;469'713.95;747'909.93;USD
01-02-2021 17:02:04;81213035;Verkauf;SOXL;DIREXION SEMICONDUCTOR BULL 3X;US25459W4583;100.0;522.72;79.56;0.00;52'192.44;USD;52'192.44;278'195.98;USD
01-02-2021 17:02:04;81213035;Verkauf;SOXL;DIREXION SEMICONDUCTOR BULL 3X;US25459W4583;100.0;522.72;159.56;0.00;52'112.44;USD;52'112.44;226'003.54;USD
01-02-2021 17:02:04;81213035;Verkauf;SOXL;DIREXION SEMICONDUCTOR BULL 3X;US25459W4583;100.0;522.75;169.57;0.00;52'105.43;USD;52'105.43;173'891.10;USD
01-02-2021 17:02:04;81213035;Verkauf;SOXL;DIREXION SEMICONDUCTOR BULL 3X;US25459W4583;100.0;522.76;259.57;0.00;52'016.43;USD;52'016.43;121'785.67;USD
01-02-2021 16:29:37;81207421;Kauf;SOXL;DIREXION SEMICONDUCTOR BULL 3X;US25459W4583;352.0;533.00;281.43;0.00;-187'897.43;USD;-187'897.43;69'769.24;USD
01-02-2021 16:29:37;81207421;Kauf;SOXL;DIREXION SEMICONDUCTOR BULL 3X;US25459W4583;37.0;533.00;29.58;0.00;-19'750.58;USD;-19'750.58;257'666.67;USD
01-02-2021 16:29:37;81207421;Kauf;SOXL;DIREXION SEMICONDUCTOR BULL 3X;US25459W4583;400.0;533.00;319.80;0.00;-213'519.80;USD;-213'519.80;277'417.25;USD
01-02-2021 16:29:36;81207421;Kauf;SOXL;DIREXION SEMICONDUCTOR BULL 3X;US25459W4583;10.0;533.00;8.00;0.00;-5'338.00;USD;-5'338.00;490'937.05;USD
01-02-2021 16:29:36;81207421;Kauf;SOXL;DIREXION SEMICONDUCTOR BULL 3X;US25459W4583;100.0;532.99;79.94;0.00;-53'378.94;USD;-53'378.94;496'275.05;USD
01-02-2021 16:29:36;81207421;Kauf;SOXL;DIREXION SEMICONDUCTOR BULL 3X;US25459W4583;100.0;532.97;79.95;0.00;-53'376.95;USD;-53'376.95;549'653.99;USD
01-02-2021 16:29:36;81207421;Kauf;SOXL;DIREXION SEMICONDUCTOR BULL 3X;US25459W4583;1.0;532.96;0.80;0.00;-533.76;USD;-533.76;603'030.94;USD
01-02-2021 16:29:36;81207421;Kauf;SOXL;DIREXION SEMICONDUCTOR BULL 3X;US25459W4583;100.0;532.96;159.94;0.00;-53'455.94;USD;-53'455.94;603'564.70;USD
01-02-2021 16:29:36;81207421;Kauf;SOXL;DIREXION SEMICONDUCTOR BULL 3X;US25459W4583;100.0;532.93;169.94;0.00;-53'462.94;USD;-53'462.94;657'020.64;USD
01-02-2021 16:29:36;81207421;Kauf;SOXL;DIREXION SEMICONDUCTOR BULL 3X;US25459W4583;100.0;532.92;259.94;0.00;-53'551.94;USD;-53'551.94;710'483.58;USD
01-02-2021 16:28:01;81206641;Verkauf;SQQQ;PROSHARES ULTRAPRO SHORT QQQ E;US74347G8612;25000.0;14.12;537.30;0.00;352'462.70;USD;352'462.70;764'035.52;USD
01-02-2021 16:28:01;81206641;Verkauf;SQQQ;PROSHARES ULTRAPRO SHORT QQQ E;US74347G8612;4300.0;14.12;92.41;0.00;60'623.59;USD;60'623.59;411'572.82;USD
01-02-2021 16:28:01;81206641;Verkauf;SQQQ;PROSHARES ULTRAPRO SHORT QQQ E;US74347G8612;5100.0;14.12;109.61;0.00;71'902.39;USD;71'902.39;350'949.23;USD
01-02-2021 16:28:01;81206641;Verkauf;SQQQ;PROSHARES ULTRAPRO SHORT QQQ E;US74347G8612;10.0;14.12;0.22;0.00;140.98;USD;140.98;279'046.84;USD
01-02-2021 16:28:01;81206641;Verkauf;SQQQ;PROSHARES ULTRAPRO SHORT QQQ E;US74347G8612;200.0;14.12;4.30;0.00;2'819.70;USD;2'819.70;278'905.86;USD
01-02-2021 16:28:01;81206641;Verkauf;SQQQ;PROSHARES ULTRAPRO SHORT QQQ E;US74347G8612;2900.0;14.12;62.32;0.00;40'885.68;USD;40'885.68;276'086.16;USD
01-02-2021 16:28:00;81206641;Verkauf;SQQQ;PROSHARES ULTRAPRO SHORT QQQ E;US74347G8612;3475.0;14.12;154.69;0.00;48'912.31;USD;48'912.31;235'200.48;USD
01-02-2021 16:28:00;81206641;Verkauf;SQQQ;PROSHARES ULTRAPRO SHORT QQQ E;US74347G8612;400.0;14.12;8.59;0.00;5'639.41;USD;5'639.41;186'288.17;USD
01-02-2021 16:28:00;81206641;Verkauf;SQQQ;PROSHARES ULTRAPRO SHORT QQQ E;US74347G8612;100.0;14.12;2.15;0.00;1'409.85;USD;1'409.85;180'648.76;USD
01-02-2021 16:28:00;81206641;Verkauf;SQQQ;PROSHARES ULTRAPRO SHORT QQQ E;US74347G8612;100.0;14.12;2.15;0.00;1'409.85;USD;1'409.85;179'238.91;USD
01-02-2021 16:28:00;81206641;Verkauf;SQQQ;PROSHARES ULTRAPRO SHORT QQQ E;US74347G8612;100.0;14.12;2.16;0.00;1'409.84;USD;1'409.84;177'829.06;USD
01-02-2021 16:28:00;81206641;Verkauf;SQQQ;PROSHARES ULTRAPRO SHORT QQQ E;US74347G8612;100.0;14.12;2.15;0.00;1'409.85;USD;1'409.85;176'419.22;USD
01-02-2021 16:28:00;81206641;Verkauf;SQQQ;PROSHARES ULTRAPRO SHORT QQQ E;US74347G8612;1600.0;14.12;124.38;0.00;22'467.62;USD;22'467.62;175'009.37;USD
01-02-2021 16:27:59;81206641;Verkauf;SQQQ;PROSHARES ULTRAPRO SHORT QQQ E;US74347G8612;100.0;14.12;2.15;0.00;1'409.85;USD;1'409.85;152'541.75;USD
01-02-2021 16:27:59;81206641;Verkauf;SQQQ;PROSHARES ULTRAPRO SHORT QQQ E;US74347G8612;100.0;14.12;2.15;0.00;1'409.85;USD;1'409.85;151'131.90;USD
01-02-2021 16:27:59;81206641;Verkauf;SQQQ;PROSHARES ULTRAPRO SHORT QQQ E;US74347G8612;100.0;14.12;2.15;0.00;1'409.85;USD;1'409.85;149'722.05;USD
01-02-2021 16:27:59;81206641;Verkauf;SQQQ;PROSHARES ULTRAPRO SHORT QQQ E;US74347G8612;100.0;14.12;2.15;0.00;1'409.85;USD;1'409.85;148'312.20;USD
01-02-2021 16:27:59;81206641;Verkauf;SQQQ;PROSHARES ULTRAPRO SHORT QQQ E;US74347G8612;100.0;14.12;2.14;0.00;1'409.86;USD;1'409.86;146'902.35;USD
01-02-2021 16:27:59;81206641;Verkauf;SQQQ;PROSHARES ULTRAPRO SHORT QQQ E;US74347G8612;100.0;14.12;2.15;0.00;1'409.85;USD;1'409.85;145'492.49;USD
01-02-2021 16:27:59;81206641;Verkauf;SQQQ;PROSHARES ULTRAPRO SHORT QQQ E;US74347G8612;100.0;14.12;2.15;0.00;1'409.85;USD;1'409.85;144'082.64;USD
01-02-2021 16:27:58;81206641;Verkauf;SQQQ;PROSHARES ULTRAPRO SHORT QQQ E;US74347G8612;1600.0;14.12;34.39;0.00;22'557.61;USD;22'557.61;142'672.79;USD
01-02-2021 16:27:58;81206641;Verkauf;SQQQ;PROSHARES ULTRAPRO SHORT QQQ E;US74347G8612;100.0;14.12;2.15;0.00;1'409.85;USD;1'409.85;120'115.18;USD
01-02-2021 16:27:58;81206641;Verkauf;SQQQ;PROSHARES ULTRAPRO SHORT QQQ E;US74347G8612;2900.0;14.12;172.33;0.00;40'775.67;USD;40'775.67;118'705.33;USD
01-02-2021 16:27:58;81206641;Verkauf;SQQQ;PROSHARES ULTRAPRO SHORT QQQ E;US74347G8612;15.0;14.12;0.32;0.00;211.48;USD;211.48;77'929.66;USD
01-02-2021 16:27:58;81206641;Verkauf;SQQQ;PROSHARES ULTRAPRO SHORT QQQ E;US74347G8612;1300.0;14.12;97.94;0.00;18'258.06;USD;18'258.06;77'718.18;USD
01-02-2021 16:06:06;00000000;Forex-Gutschrift;;;;1.0;66'548.58;0.00;0.00;66'548.58;USD;66'548.58;59'460.12;USD
01-02-2021 16:06:06;00000000;Forex-Belastung;;;;1.0;60'000.00;0.00;0.00;-60'000.00;CHF;-60'000.00;12'656.10;CHF
01-02-2021 16:00:37;81201428;Kauf;SQQQ;PROSHARES ULTRAPRO SHORT QQQ E;US74347G8612;25000.0;14.36;538.50;0.00;-359'538.50;USD;-359'538.50;-7'088.46;USD
01-02-2021 16:00:36;81201428;Kauf;SQQQ;PROSHARES ULTRAPRO SHORT QQQ E;US74347G8612;822.0;14.36;17.71;0.00;-11'821.63;USD;-11'821.63;352'450.04;USD
01-02-2021 16:00:36;81201428;Kauf;SQQQ;PROSHARES ULTRAPRO SHORT QQQ E;US74347G8612;100.0;14.36;2.15;0.00;-1'438.15;USD;-1'438.15;364'271.67;USD
01-02-2021 16:00:36;81201428;Kauf;SQQQ;PROSHARES ULTRAPRO SHORT QQQ E;US74347G8612;200.0;14.36;4.31;0.00;-2'876.31;USD;-2'876.31;365'709.82;USD
01-02-2021 16:00:36;81201428;Kauf;SQQQ;PROSHARES ULTRAPRO SHORT QQQ E;US74347G8612;5300.0;14.36;114.16;0.00;-76'222.16;USD;-76'222.16;368'586.13;USD
01-02-2021 16:00:35;81201428;Kauf;SQQQ;PROSHARES ULTRAPRO SHORT QQQ E;US74347G8612;100.0;14.36;2.15;0.00;-1'438.15;USD;-1'438.15;444'808.29;USD
01-02-2021 16:00:35;81201428;Kauf;SQQQ;PROSHARES ULTRAPRO SHORT QQQ E;US74347G8612;7300.0;14.36;157.25;0.00;-104'985.25;USD;-104'985.25;446'246.44;USD
01-02-2021 16:00:35;81201428;Kauf;SQQQ;PROSHARES ULTRAPRO SHORT QQQ E;US74347G8612;100.0;14.36;2.15;0.00;-1'438.15;USD;-1'438.15;551'231.69;USD
01-02-2021 16:00:35;81201428;Kauf;SQQQ;PROSHARES ULTRAPRO SHORT QQQ E;US74347G8612;28.0;14.36;0.60;0.00;-402.68;USD;-402.68;552'669.84;USD
01-02-2021 16:00:35;81201428;Kauf;SQQQ;PROSHARES ULTRAPRO SHORT QQQ E;US74347G8612;5300.0;14.36;284.16;0.00;-76'392.16;USD;-76'392.16;553'072.52;USD
01-02-2021 16:00:34;81201428;Kauf;SQQQ;PROSHARES ULTRAPRO SHORT QQQ E;US74347G8612;2850.0;14.36;111.39;0.00;-41'037.39;USD;-41'037.39;629'464.68;USD
01-02-2021 16:00:34;81201428;Kauf;SQQQ;PROSHARES ULTRAPRO SHORT QQQ E;US74347G8612;300.0;14.36;6.47;0.00;-4'314.47;USD;-4'314.47;670'502.07;USD
01-02-2021 16:00:34;81201428;Kauf;SQQQ;PROSHARES ULTRAPRO SHORT QQQ E;US74347G8612;2600.0;14.36;186.00;0.00;-37'522.00;USD;-37'522.00;674'816.54;USD
01-02-2021 15:57:16;00000000;Einzahlung;;;;1.0;66'000.00;0.00;0.00;66'000.00;CHF;66'000.00;72'656.10;CHF
08-01-2021 17:21:38;00000000;Bonusprogramm;;;;1.0;1'224.47;0.00;0.00;1'224.47;CHF;1'224.47;6'656.10;CHF
06-01-2021 16:18:41;79695036;Verkauf;SQQQ;PROSHARES ULTRAPRO SHORT QQQ E;US74347G8612;22500.0;15.86;543.15;0.00;356'306.85;USD;356'306.85;712'338.54;USD
06-01-2021 16:18:41;79695036;Verkauf;SQQQ;PROSHARES ULTRAPRO SHORT QQQ E;US74347G8612;3100.0;15.8605;74.84;0.00;49'092.71;USD;49'092.71;356'031.69;USD
06-01-2021 16:18:41;79695036;Verkauf;SQQQ;PROSHARES ULTRAPRO SHORT QQQ E;US74347G8612;700.0;15.8601;16.90;0.00;11'085.17;USD;11'085.17;306'938.98;USD
06-01-2021 16:18:41;79695036;Verkauf;SQQQ;PROSHARES ULTRAPRO SHORT QQQ E;US74347G8612;700.0;15.865;16.91;0.00;11'088.59;USD;11'088.59;295'853.81;USD
06-01-2021 16:18:41;79695036;Verkauf;SQQQ;PROSHARES ULTRAPRO SHORT QQQ E;US74347G8612;3100.0;15.8605;74.84;0.00;49'092.71;USD;49'092.71;284'765.22;USD
06-01-2021 16:18:41;79695036;Verkauf;SQQQ;PROSHARES ULTRAPRO SHORT QQQ E;US74347G8612;3100.0;15.863;74.84;0.00;49'100.46;USD;49'100.46;235'672.51;USD
06-01-2021 16:18:41;79695036;Verkauf;SQQQ;PROSHARES ULTRAPRO SHORT QQQ E;US74347G8612;2500.0;15.865;140.37;0.00;39'522.13;USD;39'522.13;186'572.05;USD
06-01-2021 16:18:41;79695036;Verkauf;SQQQ;PROSHARES ULTRAPRO SHORT QQQ E;US74347G8612;700.0;15.865;16.90;0.00;11'088.60;USD;11'088.60;147'049.92;USD
06-01-2021 16:18:40;79695036;Verkauf;SQQQ;PROSHARES ULTRAPRO SHORT QQQ E;US74347G8612;600.0;15.865;14.50;0.00;9'504.50;USD;9'504.50;135'961.32;USD
06-01-2021 16:18:40;79695036;Verkauf;SQQQ;PROSHARES ULTRAPRO SHORT QQQ E;US74347G8612;300.0;15.865;7.24;0.00;4'752.26;USD;4'752.26;126'456.82;USD
06-01-2021 16:18:40;79695036;Verkauf;SQQQ;PROSHARES ULTRAPRO SHORT QQQ E;US74347G8612;200.0;15.865;4.83;0.00;3'168.17;USD;3'168.17;121'704.56;USD
06-01-2021 16:18:40;79695036;Verkauf;SQQQ;PROSHARES ULTRAPRO SHORT QQQ E;US74347G8612;1000.0;15.865;24.15;0.00;15'840.85;USD;15'840.85;118'536.39;USD
06-01-2021 16:18:40;79695036;Verkauf;SQQQ;PROSHARES ULTRAPRO SHORT QQQ E;US74347G8612;700.0;15.865;106.90;0.00;10'998.60;USD;10'998.60;102'695.54;USD
06-01-2021 16:18:40;79695036;Verkauf;SQQQ;PROSHARES ULTRAPRO SHORT QQQ E;US74347G8612;300.0;15.865;7.24;0.00;4'752.26;USD;4'752.26;91'696.94;USD
06-01-2021 16:18:39;79695036;Verkauf;SQQQ;PROSHARES ULTRAPRO SHORT QQQ E;US74347G8612;600.0;15.865;14.49;0.00;9'504.51;USD;9'504.51;86'944.68;USD
06-01-2021 16:18:39;79695036;Verkauf;SQQQ;PROSHARES ULTRAPRO SHORT QQQ E;US74347G8612;800.0;15.865;19.32;0.00;12'672.68;USD;12'672.68;77'440.17;USD
06-01-2021 16:18:39;79695036;Verkauf;SQQQ;PROSHARES ULTRAPRO SHORT QQQ E;US74347G8612;200.0;15.865;4.83;0.00;3'168.17;USD;3'168.17;64'767.49;USD
06-01-2021 16:18:39;79695036;Verkauf;SQQQ;PROSHARES ULTRAPRO SHORT QQQ E;US74347G8612;200.0;15.865;4.83;0.00;3'168.17;USD;3'168.17;61'599.32;USD
06-01-2021 16:18:39;79695036;Verkauf;SQQQ;PROSHARES ULTRAPRO SHORT QQQ E;US74347G8612;300.0;15.865;7.25;0.00;4'752.25;USD;4'752.25;58'431.15;USD
06-01-2021 16:18:39;79695036;Verkauf;SQQQ;PROSHARES ULTRAPRO SHORT QQQ E;US74347G8612;800.0;15.865;69.32;0.00;12'622.68;USD;12'622.68;53'678.90;USD
06-01-2021 16:18:39;79695036;Verkauf;SQQQ;PROSHARES ULTRAPRO SHORT QQQ E;US74347G8612;800.0;15.865;54.31;0.00;12'637.69;USD;12'637.69;41'056.22;USD
06-01-2021 16:18:38;79695036;Verkauf;SQQQ;PROSHARES ULTRAPRO SHORT QQQ E;US74347G8612;600.0;15.865;39.49;0.00;9'479.51;USD;9'479.51;28'418.53;USD
06-01-2021 16:18:38;79695036;Verkauf;SQQQ;PROSHARES ULTRAPRO SHORT QQQ E;US74347G8612;200.0;15.865;4.83;0.00;3'168.17;USD;3'168.17;18'939.02;USD
06-01-2021 16:18:38;79695036;Verkauf;SQQQ;PROSHARES ULTRAPRO SHORT QQQ E;US74347G8612;700.0;15.865;51.90;0.00;11'053.60;USD;11'053.60;15'770.85;USD
06-01-2021 16:18:38;79695036;Verkauf;SQQQ;PROSHARES ULTRAPRO SHORT QQQ E;US74347G8612;300.0;15.865;42.25;0.00;4'717.25;USD;4'717.25;4'717.25;USD
04-01-2021 22:17:30;00000000;Fx-Gutschrift Comp.;;;;1.0;704'957.87;0.00;0.00;704'957.87;USD;704'957.87;0.00;USD
04-01-2021 22:17:30;00000000;Fx-Belastung Comp.;;;;1.0;625'884.16;0.00;0.00;-625'884.16;CHF;-625'884.16;5'431.63;CHF
04-01-2021 17:46:10;79574116;Kauf;SQQQ;PROSHARES ULTRAPRO SHORT QQQ E;US74347G8612;13846.0;15.85;329.19;0.00;-219'788.29;USD;-219'788.29;-704'957.87;USD
04-01-2021 17:46:10;79574116;Kauf;SQQQ;PROSHARES ULTRAPRO SHORT QQQ E;US74347G8612;1300.0;15.85;30.91;0.00;-20'635.91;USD;-20'635.91;-485'169.58;USD
04-01-2021 17:46:10;79574116;Kauf;SQQQ;PROSHARES ULTRAPRO SHORT QQQ E;US74347G8612;18000.0;15.85;427.95;0.00;-285'727.95;USD;-285'727.95;-464'533.67;USD
04-01-2021 17:46:10;79574116;Kauf;SQQQ;PROSHARES ULTRAPRO SHORT QQQ E;US74347G8612;4400.0;15.85;184.61;0.00;-69'924.61;USD;-69'924.61;-178'805.72;USD
04-01-2021 17:46:10;79574116;Kauf;SQQQ;PROSHARES ULTRAPRO SHORT QQQ E;US74347G8612;4100.0;15.85;187.48;0.00;-65'172.48;USD;-65'172.48;-108'881.11;USD
04-01-2021 17:46:09;79574116;Kauf;SQQQ;PROSHARES ULTRAPRO SHORT QQQ E;US74347G8612;2407.0;15.85;135.04;0.00;-38'285.99;USD;-38'285.99;-43'708.63;USD
04-01-2021 17:46:09;79574116;Kauf;SQQQ;PROSHARES ULTRAPRO SHORT QQQ E;US74347G8612;947.0;15.85;22.51;0.00;-15'032.46;USD;-15'032.46;-5'422.64;USD
01-01-2021 15:57:31;00000000;Jahresgebühr;;;;1.0;90.00;0.00;0.00;-90.00;CHF;-90.00;631'315.79;CHF
01-01-2021 09:00:52;00000000;Zins;;;;1.0;151.02;0.00;0.00;-151.02;USD;-151.02;9'609.82;USD
30-12-2020 10:04:41;00000000;Forex-Gutschrift;;;;1.0;623'595.84;0.00;0.00;623'595.84;CHF;623'595.84;631'405.79;CHF
30-12-2020 10:04:41;00000000;Forex-Belastung;;;;1.0;710'000.00;0.00;0.00;-710'000.00;USD;-710'000.00;9'760.84;USD
03-11-2020 16:21:30;77170735;Verkauf;SQQQ;PROSHARES ULTRAPRO SHORT QQQ E;US74347G8612;15000.0;23.25;530.83;0.00;348'219.17;USD;348'219.17;719'760.84;USD
03-11-2020 16:21:30;77170735;Verkauf;SQQQ;PROSHARES ULTRAPRO SHORT QQQ E;US74347G8612;3893.0;23.25;137.77;0.00;90'374.48;USD;90'374.48;371'541.67;USD
03-11-2020 16:21:29;77170735;Verkauf;SQQQ;PROSHARES ULTRAPRO SHORT QQQ E;US74347G8612;100.0;23.25;3.54;0.00;2'321.46;USD;2'321.46;281'167.19;USD
03-11-2020 16:21:29;77170735;Verkauf;SQQQ;PROSHARES ULTRAPRO SHORT QQQ E;US74347G8612;200.0;23.25;7.08;0.00;4'642.92;USD;4'642.92;278'845.73;USD
03-11-2020 16:21:29;77170735;Verkauf;SQQQ;PROSHARES ULTRAPRO SHORT QQQ E;US74347G8612;300.0;23.25;10.61;0.00;6'964.39;USD;6'964.39;274'202.81;USD
03-11-2020 16:21:29;77170735;Verkauf;SQQQ;PROSHARES ULTRAPRO SHORT QQQ E;US74347G8612;25.0;23.25;0.89;0.00;580.36;USD;580.36;267'238.42;USD
03-11-2020 16:21:29;77170735;Verkauf;SQQQ;PROSHARES ULTRAPRO SHORT QQQ E;US74347G8612;100.0;23.25;3.54;0.00;2'321.46;USD;2'321.46;266'658.06;USD
03-11-2020 16:21:29;77170735;Verkauf;SQQQ;PROSHARES ULTRAPRO SHORT QQQ E;US74347G8612;1.0;23.25;0.04;0.00;23.21;USD;23.21;264'336.60;USD
03-11-2020 16:21:28;77170735;Verkauf;SQQQ;PROSHARES ULTRAPRO SHORT QQQ E;US74347G8612;1.0;23.25;0.03;0.00;23.22;USD;23.22;264'313.39;USD
03-11-2020 16:21:28;77170735;Verkauf;SQQQ;PROSHARES ULTRAPRO SHORT QQQ E;US74347G8612;2.0;23.25;0.07;0.00;46.43;USD;46.43;264'290.17;USD
03-11-2020 16:21:28;77170735;Verkauf;SQQQ;PROSHARES ULTRAPRO SHORT QQQ E;US74347G8612;17.0;23.25;0.61;0.00;394.64;USD;394.64;264'243.74;USD
03-11-2020 16:21:28;77170735;Verkauf;SQQQ;PROSHARES ULTRAPRO SHORT QQQ E;US74347G8612;250.0;23.25;8.83;0.00;5'803.67;USD;5'803.67;263'849.10;USD
03-11-2020 16:21:28;77170735;Verkauf;SQQQ;PROSHARES ULTRAPRO SHORT QQQ E;US74347G8612;1.0;23.25;0.05;0.00;23.20;USD;23.20;258'045.43;USD
03-11-2020 16:21:27;77170735;Verkauf;SQQQ;PROSHARES ULTRAPRO SHORT QQQ E;US74347G8612;100.0;23.25;3.54;0.00;2'321.46;USD;2'321.46;258'022.23;USD
03-11-2020 16:21:27;77170735;Verkauf;SQQQ;PROSHARES ULTRAPRO SHORT QQQ E;US74347G8612;200.0;23.25;7.07;0.00;4'642.93;USD;4'642.93;255'700.77;USD
03-11-2020 16:21:27;77170735;Verkauf;SQQQ;PROSHARES ULTRAPRO SHORT QQQ E;US74347G8612;200.0;23.25;7.08;0.00;4'642.92;USD;4'642.92;251'057.84;USD
03-11-2020 16:21:27;77170735;Verkauf;SQQQ;PROSHARES ULTRAPRO SHORT QQQ E;US74347G8612;200.0;23.25;7.07;0.00;4'642.93;USD;4'642.93;246'414.92;USD
03-11-2020 16:21:27;77170735;Verkauf;SQQQ;PROSHARES ULTRAPRO SHORT QQQ E;US74347G8612;174.0;23.25;6.16;0.00;4'039.34;USD;4'039.34;241'771.99;USD
03-11-2020 16:21:27;77170735;Verkauf;SQQQ;PROSHARES ULTRAPRO SHORT QQQ E;US74347G8612;25.0;23.25;0.89;0.00;580.36;USD;580.36;237'732.65;USD
03-11-2020 16:21:26;77170735;Verkauf;SQQQ;PROSHARES ULTRAPRO SHORT QQQ E;US74347G8612;25.0;23.25;0.88;0.00;580.37;USD;580.37;237'152.29;USD
03-11-2020 16:21:26;77170735;Verkauf;SQQQ;PROSHARES ULTRAPRO SHORT QQQ E;US74347G8612;10.0;23.25;0.35;0.00;232.15;USD;232.15;236'571.92;USD
03-11-2020 16:21:26;77170735;Verkauf;SQQQ;PROSHARES ULTRAPRO SHORT QQQ E;US74347G8612;100.0;23.25;3.55;0.00;2'321.45;USD;2'321.45;236'339.77;USD
03-11-2020 16:21:26;77170735;Verkauf;SQQQ;PROSHARES ULTRAPRO SHORT QQQ E;US74347G8612;200.0;23.25;7.07;0.00;4'642.93;USD;4'642.93;234'018.32;USD
03-11-2020 16:21:26;77170735;Verkauf;SQQQ;PROSHARES ULTRAPRO SHORT QQQ E;US74347G8612;100.0;23.25;3.54;0.00;2'321.46;USD;2'321.46;229'375.39;USD
03-11-2020 16:21:26;77170735;Verkauf;SQQQ;PROSHARES ULTRAPRO SHORT QQQ E;US74347G8612;2000.0;23.2512;70.79;0.00;46'431.61;USD;46'431.61;227'053.93;USD
03-11-2020 16:21:25;77170735;Verkauf;SQQQ;PROSHARES ULTRAPRO SHORT QQQ E;US74347G8612;200.0;23.25;7.07;0.00;4'642.93;USD;4'642.93;180'622.32;USD
03-11-2020 16:21:25;77170735;Verkauf;SQQQ;PROSHARES ULTRAPRO SHORT QQQ E;US74347G8612;200.0;23.25;87.08;0.00;4'562.92;USD;4'562.92;175'979.39;USD
03-11-2020 16:21:25;77170735;Verkauf;SQQQ;PROSHARES ULTRAPRO SHORT QQQ E;US74347G8612;100.0;23.25;3.54;0.00;2'321.46;USD;2'321.46;171'416.47;USD
03-11-2020 16:21:25;77170735;Verkauf;SQQQ;PROSHARES ULTRAPRO SHORT QQQ E;US74347G8612;2000.0;23.2512;160.78;0.00;46'341.62;USD;46'341.62;169'095.01;USD
03-11-2020 16:21:24;77170735;Verkauf;SQQQ;PROSHARES ULTRAPRO SHORT QQQ E;US74347G8612;2000.0;23.2501;70.78;0.00;46'429.42;USD;46'429.42;122'753.39;USD
03-11-2020 16:21:24;77170735;Verkauf;SQQQ;PROSHARES ULTRAPRO SHORT QQQ E;US74347G8612;75.0;23.25;2.65;0.00;1'741.10;USD;1'741.10;76'323.97;USD
03-11-2020 16:21:24;77170735;Verkauf;SQQQ;PROSHARES ULTRAPRO SHORT QQQ E;US74347G8612;1.0;23.25;0.04;0.00;23.21;USD;23.21;74'582.87;USD
03-11-2020 16:21:24;77170735;Verkauf;SQQQ;PROSHARES ULTRAPRO SHORT QQQ E;US74347G8612;500.0;23.25;67.69;0.00;11'557.31;USD;11'557.31;74'559.66;USD
03-11-2020 16:21:23;77170735;Verkauf;SQQQ;PROSHARES ULTRAPRO SHORT QQQ E;US74347G8612;200.0;23.25;7.08;0.00;4'642.92;USD;4'642.92;63'002.35;USD
03-11-2020 16:21:23;77170735;Verkauf;SQQQ;PROSHARES ULTRAPRO SHORT QQQ E;US74347G8612;500.0;23.25;52.70;0.00;11'572.30;USD;11'572.30;58'359.43;USD
03-11-2020 16:21:23;77170735;Verkauf;SQQQ;PROSHARES ULTRAPRO SHORT QQQ E;US74347G8612;300.0;23.255;35.61;0.00;6'940.89;USD;6'940.89;46'787.13;USD
03-11-2020 16:21:23;77170735;Verkauf;SQQQ;PROSHARES ULTRAPRO SHORT QQQ E;US74347G8612;100.0;23.255;23.54;0.00;2'301.96;USD;2'301.96;39'846.24;USD
03-11-2020 16:21:23;77170735;Verkauf;SQQQ;PROSHARES ULTRAPRO SHORT QQQ E;US74347G8612;100.0;23.255;3.54;0.00;2'321.96;USD;2'321.96;37'544.28;USD
03-11-2020 16:21:22;77170735;Verkauf;SQQQ;PROSHARES ULTRAPRO SHORT QQQ E;US74347G8612;300.0;23.255;25.62;0.00;6'950.88;USD;6'950.88;35'222.32;USD
03-11-2020 16:21:22;77170735;Verkauf;SQQQ;PROSHARES ULTRAPRO SHORT QQQ E;US74347G8612;100.0;23.255;3.54;0.00;2'321.96;USD;2'321.96;28'271.44;USD
03-11-2020 16:21:22;77170735;Verkauf;SQQQ;PROSHARES ULTRAPRO SHORT QQQ E;US74347G8612;100.0;23.255;38.54;0.00;2'286.96;USD;2'286.96;25'949.48;USD
29-10-2020 20:40:54;77041474;Kauf;SQQQ;PROSHARES ULTRAPRO SHORT QQQ E;US74347G8612;14835.0;22.88;509.13;0.00;-339'933.93;USD;-339'933.93;23'662.52;USD
29-10-2020 20:40:54;77041474;Kauf;SQQQ;PROSHARES ULTRAPRO SHORT QQQ E;US74347G8612;300.0;22.87;10.30;0.00;-6'871.30;USD;-6'871.30;363'596.45;USD
29-10-2020 20:40:53;77041474;Kauf;SQQQ;PROSHARES ULTRAPRO SHORT QQQ E;US74347G8612;1000.0;22.87;34.30;0.00;-22'904.30;USD;-22'904.30;370'467.75;USD
29-10-2020 20:40:53;77041474;Kauf;SQQQ;PROSHARES ULTRAPRO SHORT QQQ E;US74347G8612;4100.0;22.87;140.65;0.00;-93'907.65;USD;-93'907.65;393'372.05;USD
29-10-2020 20:40:53;77041474;Kauf;SQQQ;PROSHARES ULTRAPRO SHORT QQQ E;US74347G8612;100.0;22.87;3.43;0.00;-2'290.43;USD;-2'290.43;487'279.70;USD
29-10-2020 20:40:53;77041474;Kauf;SQQQ;PROSHARES ULTRAPRO SHORT QQQ E;US74347G8612;465.0;22.87;15.95;0.00;-10'650.50;USD;-10'650.50;489'570.13;USD
29-10-2020 20:40:53;77041474;Kauf;SQQQ;PROSHARES ULTRAPRO SHORT QQQ E;US74347G8612;600.0;22.87;20.59;0.00;-13'742.59;USD;-13'742.59;500'220.63;USD
29-10-2020 20:40:53;77041474;Kauf;SQQQ;PROSHARES ULTRAPRO SHORT QQQ E;US74347G8612;1400.0;22.87;48.02;0.00;-32'066.02;USD;-32'066.02;513'963.22;USD
29-10-2020 20:40:53;77041474;Kauf;SQQQ;PROSHARES ULTRAPRO SHORT QQQ E;US74347G8612;100.0;22.87;3.43;0.00;-2'290.43;USD;-2'290.43;546'029.24;USD
29-10-2020 20:40:52;77041474;Kauf;SQQQ;PROSHARES ULTRAPRO SHORT QQQ E;US74347G8612;200.0;22.87;6.87;0.00;-4'580.87;USD;-4'580.87;548'319.67;USD
29-10-2020 20:40:52;77041474;Kauf;SQQQ;PROSHARES ULTRAPRO SHORT QQQ E;US74347G8612;100.0;22.87;3.43;0.00;-2'290.43;USD;-2'290.43;552'900.54;USD
29-10-2020 20:40:52;77041474;Kauf;SQQQ;PROSHARES ULTRAPRO SHORT QQQ E;US74347G8612;400.0;22.87;93.72;0.00;-9'241.72;USD;-9'241.72;555'190.97;USD
29-10-2020 20:40:52;77041474;Kauf;SQQQ;PROSHARES ULTRAPRO SHORT QQQ E;US74347G8612;200.0;22.87;6.86;0.00;-4'580.86;USD;-4'580.86;564'432.69;USD
29-10-2020 20:40:52;77041474;Kauf;SQQQ;PROSHARES ULTRAPRO SHORT QQQ E;US74347G8612;100.0;22.87;3.43;0.00;-2'290.43;USD;-2'290.43;569'013.55;USD
29-10-2020 20:40:52;77041474;Kauf;SQQQ;PROSHARES ULTRAPRO SHORT QQQ E;US74347G8612;1000.0;22.87;34.30;0.00;-22'904.30;USD;-22'904.30;571'303.98;USD
29-10-2020 20:40:52;77041474;Kauf;SQQQ;PROSHARES ULTRAPRO SHORT QQQ E;US74347G8612;400.0;22.87;13.73;0.00;-9'161.73;USD;-9'161.73;594'208.28;USD
29-10-2020 20:40:52;77041474;Kauf;SQQQ;PROSHARES ULTRAPRO SHORT QQQ E;US74347G8612;200.0;22.87;6.86;0.00;-4'580.86;USD;-4'580.86;603'370.01;USD
29-10-2020 20:40:51;77041474;Kauf;SQQQ;PROSHARES ULTRAPRO SHORT QQQ E;US74347G8612;200.0;22.87;96.86;0.00;-4'670.86;USD;-4'670.86;607'950.87;USD
29-10-2020 20:40:51;77041474;Kauf;SQQQ;PROSHARES ULTRAPRO SHORT QQQ E;US74347G8612;280.0;22.87;9.60;0.00;-6'413.20;USD;-6'413.20;612'621.73;USD
29-10-2020 20:40:51;77041474;Kauf;SQQQ;PROSHARES ULTRAPRO SHORT QQQ E;US74347G8612;800.0;22.87;27.45;0.00;-18'323.45;USD;-18'323.45;619'034.93;USD
29-10-2020 20:40:51;77041474;Kauf;SQQQ;PROSHARES ULTRAPRO SHORT QQQ E;US74347G8612;200.0;22.87;6.86;0.00;-4'580.86;USD;-4'580.86;637'358.38;USD
29-10-2020 20:40:51;77041474;Kauf;SQQQ;PROSHARES ULTRAPRO SHORT QQQ E;US74347G8612;200.0;22.87;6.86;0.00;-4'580.86;USD;-4'580.86;641'939.24;USD
29-10-2020 20:40:51;77041474;Kauf;SQQQ;PROSHARES ULTRAPRO SHORT QQQ E;US74347G8612;1000.0;22.87;84.30;0.00;-22'954.30;USD;-22'954.30;646'520.10;USD
29-10-2020 20:40:51;77041474;Kauf;SQQQ;PROSHARES ULTRAPRO SHORT QQQ E;US74347G8612;400.0;22.87;13.73;0.00;-9'161.73;USD;-9'161.73;669'474.40;USD
29-10-2020 20:40:50;77041474;Kauf;SQQQ;PROSHARES ULTRAPRO SHORT QQQ E;US74347G8612;100.0;22.87;3.43;0.00;-2'290.43;USD;-2'290.43;678'636.13;USD
29-10-2020 20:40:50;77041474;Kauf;SQQQ;PROSHARES ULTRAPRO SHORT QQQ E;US74347G8612;100.0;22.87;38.43;0.00;-2'325.43;USD;-2'325.43;680'926.56;USD
29-10-2020 20:40:50;77041474;Kauf;SQQQ;PROSHARES ULTRAPRO SHORT QQQ E;US74347G8612;1000.0;22.87;89.30;0.00;-22'959.30;USD;-22'959.30;683'251.99;USD
29-10-2020 20:40:50;77041474;Kauf;SQQQ;PROSHARES ULTRAPRO SHORT QQQ E;US74347G8612;220.0;22.87;47.55;0.00;-5'078.95;USD;-5'078.95;706'211.29;USD
29-10-2020 20:06:06;77040481;Verkauf;SQQQ;PROSHARES ULTRAPRO SHORT QQQ E;US74347G8612;10600.0;22.74;366.90;0.00;240'677.10;USD;240'677.10;711'290.24;USD
29-10-2020 20:06:06;77040481;Verkauf;SQQQ;PROSHARES ULTRAPRO SHORT QQQ E;US74347G8612;2068.0;22.74;71.57;0.00;46'954.75;USD;46'954.75;470'613.14;USD
29-10-2020 20:06:06;77040481;Verkauf;SQQQ;PROSHARES ULTRAPRO SHORT QQQ E;US74347G8612;1824.0;22.74;63.13;0.00;41'414.63;USD;41'414.63;423'658.39;USD
29-10-2020 20:06:05;77040481;Verkauf;SQQQ;PROSHARES ULTRAPRO SHORT QQQ E;US74347G8612;14.0;22.74;0.49;0.00;317.87;USD;317.87;382'243.76;USD
29-10-2020 20:06:05;77040481;Verkauf;SQQQ;PROSHARES ULTRAPRO SHORT QQQ E;US74347G8612;800.0;22.74;27.69;0.00;18'164.31;USD;18'164.31;381'925.89;USD
29-10-2020 20:06:05;77040481;Verkauf;SQQQ;PROSHARES ULTRAPRO SHORT QQQ E;US74347G8612;130.0;22.74;4.50;0.00;2'951.70;USD;2'951.70;363'761.58;USD
29-10-2020 20:06:05;77040481;Verkauf;SQQQ;PROSHARES ULTRAPRO SHORT QQQ E;US74347G8612;100.0;22.74;3.46;0.00;2'270.54;USD;2'270.54;360'809.88;USD
29-10-2020 20:06:05;77040481;Verkauf;SQQQ;PROSHARES ULTRAPRO SHORT QQQ E;US74347G8612;179.0;22.74;6.20;0.00;4'064.26;USD;4'064.26;358'539.34;USD
29-10-2020 20:06:05;77040481;Verkauf;SQQQ;PROSHARES ULTRAPRO SHORT QQQ E;US74347G8612;457.0;22.74;15.82;0.00;10'376.36;USD;10'376.36;354'475.08;USD
29-10-2020 20:06:04;77040481;Verkauf;SQQQ;PROSHARES ULTRAPRO SHORT QQQ E;US74347G8612;800.0;22.74;27.68;0.00;18'164.32;USD;18'164.32;344'098.72;USD
29-10-2020 20:06:04;77040481;Verkauf;SQQQ;PROSHARES ULTRAPRO SHORT QQQ E;US74347G8612;100.0;22.74;3.47;0.00;2'270.53;USD;2'270.53;325'934.40;USD
29-10-2020 20:06:04;77040481;Verkauf;SQQQ;PROSHARES ULTRAPRO SHORT QQQ E;US74347G8612;3000.0;22.74;103.84;0.00;68'116.16;USD;68'116.16;323'663.87;USD
29-10-2020 20:06:04;77040481;Verkauf;SQQQ;PROSHARES ULTRAPRO SHORT QQQ E;US74347G8612;400.0;22.74;13.84;0.00;9'082.16;USD;9'082.16;255'547.71;USD
29-10-2020 20:06:04;77040481;Verkauf;SQQQ;PROSHARES ULTRAPRO SHORT QQQ E;US74347G8612;818.0;22.74;28.31;0.00;18'573.01;USD;18'573.01;246'465.55;USD
29-10-2020 20:04:57;77040481;Verkauf;SQQQ;PROSHARES ULTRAPRO SHORT QQQ E;US74347G8612;6710.0;22.74;582.25;0.00;152'003.15;USD;152'003.15;227'892.54;USD
29-10-2020 19:52:05;77040794;Kauf;SQQQ;PROSHARES ULTRAPRO SHORT QQQ E;US74347G8612;14000.0;22.87;480.27;0.00;-320'660.27;USD;-320'660.27;75'889.39;USD
29-10-2020 19:52:05;77040794;Kauf;SQQQ;PROSHARES ULTRAPRO SHORT QQQ E;US74347G8612;500.0;22.8673;17.15;0.00;-11'450.80;USD;-11'450.80;396'549.66;USD
29-10-2020 19:52:05;77040794;Kauf;SQQQ;PROSHARES ULTRAPRO SHORT QQQ E;US74347G8612;2500.0;22.8695;85.76;0.00;-57'259.51;USD;-57'259.51;408'000.46;USD
29-10-2020 19:52:05;77040794;Kauf;SQQQ;PROSHARES ULTRAPRO SHORT QQQ E;US74347G8612;2000.0;22.8673;68.60;0.00;-45'803.20;USD;-45'803.20;465'259.97;USD
29-10-2020 19:52:05;77040794;Kauf;SQQQ;PROSHARES ULTRAPRO SHORT QQQ E;US74347G8612;2500.0;22.8695;165.77;0.00;-57'339.52;USD;-57'339.52;511'063.17;USD
29-10-2020 19:52:04;77040794;Kauf;SQQQ;PROSHARES ULTRAPRO SHORT QQQ E;US74347G8612;2000.0;22.8673;68.60;0.00;-45'803.20;USD;-45'803.20;568'402.69;USD
29-10-2020 19:52:04;77040794;Kauf;SQQQ;PROSHARES ULTRAPRO SHORT QQQ E;US74347G8612;2500.0;22.8695;225.76;0.00;-57'399.51;USD;-57'399.51;614'205.89;USD
29-10-2020 19:52:04;77040794;Kauf;SQQQ;PROSHARES ULTRAPRO SHORT QQQ E;US74347G8612;2000.0;22.8673;198.60;0.00;-45'933.20;USD;-45'933.20;671'605.40;USD
29-10-2020 19:48:07;77040286;Verkauf;TQQQ;PROSHARES ULTRAPRO QQQ ETF;US74347X8314;3400.0;129.25;838.89;0.00;438'611.11;USD;438'611.11;717'538.60;USD
29-10-2020 19:48:07;77040286;Verkauf;TQQQ;PROSHARES ULTRAPRO QQQ ETF;US74347X8314;94.0;129.253;18.49;0.00;12'131.29;USD;12'131.29;278'927.49;USD
29-10-2020 19:48:07;77040286;Verkauf;TQQQ;PROSHARES ULTRAPRO QQQ ETF;US74347X8314;100.0;129.253;19.68;0.00;12'905.62;USD;12'905.62;266'796.20;USD
29-10-2020 19:48:07;77040286;Verkauf;TQQQ;PROSHARES ULTRAPRO QQQ ETF;US74347X8314;100.0;129.253;69.67;0.00;12'855.63;USD;12'855.63;253'890.58;USD
29-10-2020 19:48:07;77040286;Verkauf;TQQQ;PROSHARES ULTRAPRO QQQ ETF;US74347X8314;100.0;129.25;54.67;0.00;12'870.33;USD;12'870.33;241'034.95;USD
29-10-2020 19:48:07;77040286;Verkauf;TQQQ;PROSHARES ULTRAPRO QQQ ETF;US74347X8314;100.0;129.25;64.68;0.00;12'860.32;USD;12'860.32;228'164.62;USD
29-10-2020 19:48:06;77040286;Verkauf;TQQQ;PROSHARES ULTRAPRO QQQ ETF;US74347X8314;100.0;129.25;44.67;0.00;12'880.33;USD;12'880.33;215'304.30;USD
29-10-2020 19:48:06;77040286;Verkauf;TQQQ;PROSHARES ULTRAPRO QQQ ETF;US74347X8314;6.0;129.25;26.18;0.00;749.32;USD;749.32;202'423.97;USD
29-10-2020 19:26:19;77039474;Kauf;TQQQ;PROSHARES ULTRAPRO QQQ ETF;US74347X8314;4000.0;129.81;1'128.86;0.00;-520'368.86;USD;-520'368.86;201'674.65;USD
29-10-2020 19:25:14;77039976;Verkauf;SQQQ;PROSHARES ULTRAPRO SHORT QQQ E;US74347G8612;15000.0;22.61;516.21;0.00;338'633.79;USD;338'633.79;722'043.51;USD
29-10-2020 19:25:14;77039976;Verkauf;SQQQ;PROSHARES ULTRAPRO SHORT QQQ E;US74347G8612;2000.0;22.6116;68.84;0.00;45'154.36;USD;45'154.36;383'409.72;USD
29-10-2020 19:25:13;77039976;Verkauf;SQQQ;PROSHARES ULTRAPRO SHORT QQQ E;US74347G8612;75.0;22.6125;2.58;0.00;1'693.36;USD;1'693.36;338'255.36;USD
29-10-2020 19:25:13;77039976;Verkauf;SQQQ;PROSHARES ULTRAPRO SHORT QQQ E;US74347G8612;2000.0;22.6116;68.84;0.00;45'154.36;USD;45'154.36;336'562.00;USD
29-10-2020 19:25:13;77039976;Verkauf;SQQQ;PROSHARES ULTRAPRO SHORT QQQ E;US74347G8612;500.0;22.6125;17.21;0.00;11'289.04;USD;11'289.04;291'407.64;USD
29-10-2020 19:25:13;77039976;Verkauf;SQQQ;PROSHARES ULTRAPRO SHORT QQQ E;US74347G8612;2000.0;22.6116;68.83;0.00;45'154.37;USD;45'154.37;280'118.60;USD
29-10-2020 19:25:13;77039976;Verkauf;SQQQ;PROSHARES ULTRAPRO SHORT QQQ E;US74347G8612;500.0;22.6125;17.21;0.00;11'289.04;USD;11'289.04;234'964.23;USD
29-10-2020 19:25:12;77039976;Verkauf;SQQQ;PROSHARES ULTRAPRO SHORT QQQ E;US74347G8612;500.0;22.6125;17.21;0.00;11'289.04;USD;11'289.04;223'675.19;USD
29-10-2020 19:25:12;77039976;Verkauf;SQQQ;PROSHARES ULTRAPRO SHORT QQQ E;US74347G8612;2000.0;22.6116;148.84;0.00;45'074.36;USD;45'074.36;212'386.15;USD
29-10-2020 19:25:12;77039976;Verkauf;SQQQ;PROSHARES ULTRAPRO SHORT QQQ E;US74347G8612;2000.0;22.6116;158.83;0.00;45'064.37;USD;45'064.37;167'311.79;USD
29-10-2020 19:25:12;77039976;Verkauf;SQQQ;PROSHARES ULTRAPRO SHORT QQQ E;US74347G8612;500.0;22.6125;17.21;0.00;11'289.04;USD;11'289.04;122'247.42;USD
29-10-2020 19:25:12;77039976;Verkauf;SQQQ;PROSHARES ULTRAPRO SHORT QQQ E;US74347G8612;100.0;22.61;3.44;0.00;2'257.56;USD;2'257.56;110'958.38;USD
29-10-2020 19:25:11;77039976;Verkauf;SQQQ;PROSHARES ULTRAPRO SHORT QQQ E;US74347G8612;300.0;22.61;10.33;0.00;6'772.67;USD;6'772.67;108'700.82;USD
29-10-2020 19:25:11;77039976;Verkauf;SQQQ;PROSHARES ULTRAPRO SHORT QQQ E;US74347G8612;5.0;22.61;0.17;0.00;112.88;USD;112.88;101'928.15;USD
29-10-2020 19:25:11;77039976;Verkauf;SQQQ;PROSHARES ULTRAPRO SHORT QQQ E;US74347G8612;20.0;22.61;0.68;0.00;451.52;USD;451.52;101'815.27;USD
29-10-2020 19:25:11;77039976;Verkauf;SQQQ;PROSHARES ULTRAPRO SHORT QQQ E;US74347G8612;2000.0;22.6117;198.84;0.00;45'024.56;USD;45'024.56;101'363.75;USD
29-10-2020 19:25:11;77039976;Verkauf;SQQQ;PROSHARES ULTRAPRO SHORT QQQ E;US74347G8612;500.0;22.615;67.21;0.00;11'240.29;USD;11'240.29;56'339.19;USD
19-10-2020 16:11:59;76669330;Kauf;SQQQ;PROSHARES ULTRAPRO SHORT QQQ E;US74347G8612;15000.0;20.91;470.47;0.00;-314'120.47;USD;-314'120.47;45'098.90;USD
19-10-2020 16:11:59;76669330;Kauf;SQQQ;PROSHARES ULTRAPRO SHORT QQQ E;US74347G8612;300.0;20.907;9.41;0.00;-6'281.51;USD;-6'281.51;359'219.37;USD
19-10-2020 16:11:59;76669330;Kauf;SQQQ;PROSHARES ULTRAPRO SHORT QQQ E;US74347G8612;2500.0;20.9095;78.41;0.00;-52'352.16;USD;-52'352.16;365'500.88;USD
19-10-2020 16:11:59;76669330;Kauf;SQQQ;PROSHARES ULTRAPRO SHORT QQQ E;US74347G8612;1400.0;20.9075;43.91;0.00;-29'314.41;USD;-29'314.41;417'853.04;USD
19-10-2020 16:11:58;76669330;Kauf;SQQQ;PROSHARES ULTRAPRO SHORT QQQ E;US74347G8612;2500.0;20.905;78.39;0.00;-52'340.89;USD;-52'340.89;447'167.45;USD
19-10-2020 16:11:58;76669330;Kauf;SQQQ;PROSHARES ULTRAPRO SHORT QQQ E;US74347G8612;400.0;20.905;12.54;0.00;-8'374.54;USD;-8'374.54;499'508.34;USD
19-10-2020 16:11:58;76669330;Kauf;SQQQ;PROSHARES ULTRAPRO SHORT QQQ E;US74347G8612;2500.0;20.9095;158.41;0.00;-52'432.16;USD;-52'432.16;507'882.88;USD
19-10-2020 16:11:58;76669330;Kauf;SQQQ;PROSHARES ULTRAPRO SHORT QQQ E;US74347G8612;1400.0;20.9075;133.91;0.00;-29'404.41;USD;-29'404.41;560'315.04;USD
19-10-2020 16:11:58;76669330;Kauf;SQQQ;PROSHARES ULTRAPRO SHORT QQQ E;US74347G8612;2500.0;20.908;128.40;0.00;-52'398.40;USD;-52'398.40;589'719.45;USD
19-10-2020 16:11:57;76669330;Kauf;SQQQ;PROSHARES ULTRAPRO SHORT QQQ E;US74347G8612;500.0;20.905;50.68;0.00;-10'503.18;USD;-10'503.18;642'117.85;USD
19-10-2020 16:11:57;76669330;Kauf;SQQQ;PROSHARES ULTRAPRO SHORT QQQ E;US74347G8612;100.0;20.905;28.14;0.00;-2'118.64;USD;-2'118.64;652'621.03;USD
19-10-2020 16:11:57;76669330;Kauf;SQQQ;PROSHARES ULTRAPRO SHORT QQQ E;US74347G8612;300.0;20.905;29.41;0.00;-6'300.91;USD;-6'300.91;654'739.67;USD
19-10-2020 16:11:57;76669330;Kauf;SQQQ;PROSHARES ULTRAPRO SHORT QQQ E;US74347G8612;100.0;20.905;3.13;0.00;-2'093.63;USD;-2'093.63;661'040.58;USD
19-10-2020 16:11:57;76669330;Kauf;SQQQ;PROSHARES ULTRAPRO SHORT QQQ E;US74347G8612;300.0;20.905;24.41;0.00;-6'295.91;USD;-6'295.91;663'134.21;USD
19-10-2020 16:11:57;76669330;Kauf;SQQQ;PROSHARES ULTRAPRO SHORT QQQ E;US74347G8612;100.0;20.905;3.13;0.00;-2'093.63;USD;-2'093.63;669'430.12;USD
19-10-2020 16:11:56;76669330;Kauf;SQQQ;PROSHARES ULTRAPRO SHORT QQQ E;US74347G8612;100.0;20.905;38.14;0.00;-2'128.64;USD;-2'128.64;671'523.75;USD
16-10-2020 18:39:05;76635037;Verkauf;TQQQ;PROSHARES ULTRAPRO QQQ ETF;US74347X8314;3300.0;147.56;821.18;0.00;486'126.82;USD;486'126.82;673'652.39;USD
16-10-2020 18:39:05;76635037;Verkauf;TQQQ;PROSHARES ULTRAPRO QQQ ETF;US74347X8314;100.0;147.57;112.46;0.00;14'644.54;USD;14'644.54;187'525.57;USD
16-10-2020 18:39:05;76635037;Verkauf;TQQQ;PROSHARES ULTRAPRO QQQ ETF;US74347X8314;100.0;147.57;22.46;0.00;14'734.54;USD;14'734.54;172'881.03;USD
16-10-2020 18:39:04;76635037;Verkauf;TQQQ;PROSHARES ULTRAPRO QQQ ETF;US74347X8314;100.0;147.57;22.47;0.00;14'734.53;USD;14'734.53;158'146.49;USD
16-10-2020 18:39:04;76635037;Verkauf;TQQQ;PROSHARES ULTRAPRO QQQ ETF;US74347X8314;100.0;147.57;72.45;0.00;14'684.55;USD;14'684.55;143'411.96;USD
16-10-2020 18:39:04;76635037;Verkauf;TQQQ;PROSHARES ULTRAPRO QQQ ETF;US74347X8314;200.0;147.57;124.92;0.00;29'389.08;USD;29'389.08;128'727.41;USD
16-10-2020 18:39:04;76635037;Verkauf;TQQQ;PROSHARES ULTRAPRO QQQ ETF;US74347X8314;100.0;147.58;72.47;0.00;14'685.53;USD;14'685.53;99'338.33;USD
16-10-2020 17:31:06;76633193;Kauf;TQQQ;PROSHARES ULTRAPRO QQQ ETF;US74347X8314;134.0;148.15;29.78;0.00;-19'881.88;USD;-19'881.88;84'652.80;USD
16-10-2020 17:31:06;76633193;Kauf;TQQQ;PROSHARES ULTRAPRO QQQ ETF;US74347X8314;100.0;148.15;22.22;0.00;-14'837.22;USD;-14'837.22;104'534.68;USD
16-10-2020 17:31:06;76633193;Kauf;TQQQ;PROSHARES ULTRAPRO QQQ ETF;US74347X8314;1500.0;148.15;333.34;0.00;-222'558.34;USD;-222'558.34;119'371.90;USD
16-10-2020 17:31:05;76633193;Kauf;TQQQ;PROSHARES ULTRAPRO QQQ ETF;US74347X8314;9.0;148.15;2.00;0.00;-1'335.35;USD;-1'335.35;341'930.24;USD
16-10-2020 17:31:05;76633193;Kauf;TQQQ;PROSHARES ULTRAPRO QQQ ETF;US74347X8314;27.0;148.15;6.00;0.00;-4'006.05;USD;-4'006.05;343'265.59;USD
16-10-2020 17:31:05;76633193;Kauf;TQQQ;PROSHARES ULTRAPRO QQQ ETF;US74347X8314;14.0;148.15;3.11;0.00;-2'077.21;USD;-2'077.21;347'271.64;USD
16-10-2020 17:31:05;76633193;Kauf;TQQQ;PROSHARES ULTRAPRO QQQ ETF;US74347X8314;66.0;148.15;14.67;0.00;-9'792.57;USD;-9'792.57;349'348.85;USD
16-10-2020 17:31:05;76633193;Kauf;TQQQ;PROSHARES ULTRAPRO QQQ ETF;US74347X8314;100.0;148.15;22.22;0.00;-14'837.22;USD;-14'837.22;359'141.42;USD
16-10-2020 17:31:04;76633193;Kauf;TQQQ;PROSHARES ULTRAPRO QQQ ETF;US74347X8314;66.0;148.15;14.67;0.00;-9'792.57;USD;-9'792.57;373'978.64;USD
16-10-2020 17:31:04;76633193;Kauf;TQQQ;PROSHARES ULTRAPRO QQQ ETF;US74347X8314;9.0;148.15;2.00;0.00;-1'335.35;USD;-1'335.35;383'771.21;USD
16-10-2020 17:31:04;76633193;Kauf;TQQQ;PROSHARES ULTRAPRO QQQ ETF;US74347X8314;100.0;148.15;22.22;0.00;-14'837.22;USD;-14'837.22;385'106.56;USD
16-10-2020 17:31:04;76633193;Kauf;TQQQ;PROSHARES ULTRAPRO QQQ ETF;US74347X8314;100.0;148.15;22.22;0.00;-14'837.22;USD;-14'837.22;399'943.78;USD
16-10-2020 17:31:04;76633193;Kauf;TQQQ;PROSHARES ULTRAPRO QQQ ETF;US74347X8314;400.0;148.15;88.89;0.00;-59'348.89;USD;-59'348.89;414'781.00;USD
16-10-2020 17:31:03;76633193;Kauf;TQQQ;PROSHARES ULTRAPRO QQQ ETF;US74347X8314;12.0;148.15;2.67;0.00;-1'780.47;USD;-1'780.47;474'129.89;USD
16-10-2020 17:31:03;76633193;Kauf;TQQQ;PROSHARES ULTRAPRO QQQ ETF;US74347X8314;39.0;148.15;8.66;0.00;-5'786.51;USD;-5'786.51;475'910.36;USD
16-10-2020 17:31:03;76633193;Kauf;TQQQ;PROSHARES ULTRAPRO QQQ ETF;US74347X8314;22.0;148.15;4.89;0.00;-3'264.19;USD;-3'264.19;481'696.87;USD
16-10-2020 17:31:03;76633193;Kauf;TQQQ;PROSHARES ULTRAPRO QQQ ETF;US74347X8314;54.0;148.15;12.00;0.00;-8'012.10;USD;-8'012.10;484'961.06;USD
16-10-2020 17:31:02;76633193;Kauf;TQQQ;PROSHARES ULTRAPRO QQQ ETF;US74347X8314;200.0;148.15;44.45;0.00;-29'674.45;USD;-29'674.45;492'973.16;USD
16-10-2020 17:31:02;76633193;Kauf;TQQQ;PROSHARES ULTRAPRO QQQ ETF;US74347X8314;541.0;148.15;290.22;0.00;-80'439.37;USD;-80'439.37;522'647.61;USD
16-10-2020 17:31:02;76633193;Kauf;TQQQ;PROSHARES ULTRAPRO QQQ ETF;US74347X8314;100.0;148.15;22.22;0.00;-14'837.22;USD;-14'837.22;603'086.98;USD
16-10-2020 17:31:01;76633193;Kauf;TQQQ;PROSHARES ULTRAPRO QQQ ETF;US74347X8314;407.0;148.15;270.45;0.00;-60'567.50;USD;-60'567.50;617'924.20;USD
16-10-2020 17:29:20;76633296;Verkauf;SQQQ;PROSHARES ULTRAPRO SHORT QQQ E;US74347G8612;1974.0;20.44;61.42;0.00;40'287.14;USD;40'287.14;678'491.70;USD
16-10-2020 17:29:20;76633296;Verkauf;SQQQ;PROSHARES ULTRAPRO SHORT QQQ E;US74347G8612;800.0;20.44;24.89;0.00;16'327.11;USD;16'327.11;638'204.56;USD
16-10-2020 17:29:20;76633296;Verkauf;SQQQ;PROSHARES ULTRAPRO SHORT QQQ E;US74347G8612;800.0;20.44;24.89;0.00;16'327.11;USD;16'327.11;621'877.45;USD
16-10-2020 17:29:19;76633296;Verkauf;SQQQ;PROSHARES ULTRAPRO SHORT QQQ E;US74347G8612;1100.0;20.44;34.22;0.00;22'449.78;USD;22'449.78;605'550.34;USD
16-10-2020 17:29:19;76633296;Verkauf;SQQQ;PROSHARES ULTRAPRO SHORT QQQ E;US74347G8612;100.0;20.44;3.11;0.00;2'040.89;USD;2'040.89;583'100.56;USD
16-10-2020 17:29:19;76633296;Verkauf;SQQQ;PROSHARES ULTRAPRO SHORT QQQ E;US74347G8612;25100.0;20.44;1'000.91;0.00;512'043.09;USD;512'043.09;581'059.67;USD
16-10-2020 17:29:19;76633296;Verkauf;SQQQ;PROSHARES ULTRAPRO SHORT QQQ E;US74347G8612;2126.0;20.44;196.14;0.00;43'259.30;USD;43'259.30;69'016.58;USD
16-10-2020 17:24:22;76632657;Kauf;SQQQ;PROSHARES ULTRAPRO SHORT QQQ E;US74347G8612;16000.0;20.52;492.48;0.00;-328'812.48;USD;-328'812.48;25'757.28;USD
16-10-2020 17:24:22;76632657;Kauf;SQQQ;PROSHARES ULTRAPRO SHORT QQQ E;US74347G8612;300.0;20.515;9.23;0.00;-6'163.73;USD;-6'163.73;354'569.76;USD
16-10-2020 17:24:22;76632657;Kauf;SQQQ;PROSHARES ULTRAPRO SHORT QQQ E;US74347G8612;2500.0;20.5199;76.95;0.00;-51'376.70;USD;-51'376.70;360'733.49;USD
16-10-2020 17:24:21;76632657;Kauf;SQQQ;PROSHARES ULTRAPRO SHORT QQQ E;US74347G8612;1400.0;20.5186;43.09;0.00;-28'769.13;USD;-28'769.13;412'110.19;USD
16-10-2020 17:24:21;76632657;Kauf;SQQQ;PROSHARES ULTRAPRO SHORT QQQ E;US74347G8612;1400.0;20.5186;43.09;0.00;-28'769.13;USD;-28'769.13;440'879.32;USD
16-10-2020 17:24:21;76632657;Kauf;SQQQ;PROSHARES ULTRAPRO SHORT QQQ E;US74347G8612;2500.0;20.515;76.93;0.00;-51'364.43;USD;-51'364.43;469'648.45;USD
16-10-2020 17:24:21;76632657;Kauf;SQQQ;PROSHARES ULTRAPRO SHORT QQQ E;US74347G8612;1400.0;20.5189;123.09;0.00;-28'849.55;USD;-28'849.55;521'012.88;USD
16-10-2020 17:24:21;76632657;Kauf;SQQQ;PROSHARES ULTRAPRO SHORT QQQ E;US74347G8612;2500.0;20.5199;166.95;0.00;-51'466.70;USD;-51'466.70;549'862.43;USD
16-10-2020 17:24:20;76632657;Kauf;SQQQ;PROSHARES ULTRAPRO SHORT QQQ E;US74347G8612;1400.0;20.5175;43.08;0.00;-28'767.58;USD;-28'767.58;601'329.13;USD
16-10-2020 17:24:20;76632657;Kauf;SQQQ;PROSHARES ULTRAPRO SHORT QQQ E;US74347G8612;2500.0;20.5199;221.95;0.00;-51'521.70;USD;-51'521.70;630'096.71;USD
16-10-2020 17:24:20;76632657;Kauf;SQQQ;PROSHARES ULTRAPRO SHORT QQQ E;US74347G8612;100.0;20.515;38.08;0.00;-2'089.58;USD;-2'089.58;681'618.41;USD
16-10-2020 17:21:23;76632540;Verkauf;TQQQ;PROSHARES ULTRAPRO QQQ ETF;US74347X8314;4000.0;147.74;1'249.50;0.00;589'710.50;USD;589'710.50;683'707.99;USD
15-10-2020 21:47:53;76605313;Kauf;TQQQ;PROSHARES ULTRAPRO QQQ ETF;US74347X8314;2000.0;147.40;442.20;0.00;-295'242.20;USD;-295'242.20;93'997.49;USD
15-10-2020 21:47:53;76605313;Kauf;TQQQ;PROSHARES ULTRAPRO QQQ ETF;US74347X8314;1179.0;147.41;340.69;0.00;-174'137.08;USD;-174'137.08;389'239.69;USD
15-10-2020 21:47:53;76605313;Kauf;TQQQ;PROSHARES ULTRAPRO QQQ ETF;US74347X8314;331.0;147.41;163.19;0.00;-48'955.90;USD;-48'955.90;563'376.77;USD
15-10-2020 21:47:52;76605313;Kauf;TQQQ;PROSHARES ULTRAPRO QQQ ETF;US74347X8314;181.0;147.41;90.03;0.00;-26'771.24;USD;-26'771.24;612'332.67;USD
15-10-2020 21:47:52;76605313;Kauf;TQQQ;PROSHARES ULTRAPRO QQQ ETF;US74347X8314;193.0;147.41;102.67;0.00;-28'552.80;USD;-28'552.80;639'103.91;USD
15-10-2020 21:47:52;76605313;Kauf;TQQQ;PROSHARES ULTRAPRO QQQ ETF;US74347X8314;116.0;147.41;95.65;0.00;-17'195.21;USD;-17'195.21;667'656.71;USD
15-10-2020 21:19:17;76604926;Verkauf;SQQQ;PROSHARES ULTRAPRO SHORT QQQ E;US74347G8612;16500.0;20.49;514.60;0.00;337'570.40;USD;337'570.40;684'851.92;USD
15-10-2020 21:19:17;76604926;Verkauf;SQQQ;PROSHARES ULTRAPRO SHORT QQQ E;US74347G8612;100.0;20.4925;3.11;0.00;2'046.14;USD;2'046.14;347'281.52;USD
15-10-2020 21:19:17;76604926;Verkauf;SQQQ;PROSHARES ULTRAPRO SHORT QQQ E;US74347G8612;2500.0;20.4905;77.98;0.00;51'148.27;USD;51'148.27;345'235.38;USD
15-10-2020 21:19:16;76604926;Verkauf;SQQQ;PROSHARES ULTRAPRO SHORT QQQ E;US74347G8612;1400.0;20.4925;43.67;0.00;28'645.83;USD;28'645.83;294'087.11;USD
15-10-2020 21:19:16;76604926;Verkauf;SQQQ;PROSHARES ULTRAPRO SHORT QQQ E;US74347G8612;2500.0;20.4905;77.96;0.00;51'148.29;USD;51'148.29;265'441.28;USD
15-10-2020 21:19:16;76604926;Verkauf;SQQQ;PROSHARES ULTRAPRO SHORT QQQ E;US74347G8612;1400.0;20.4925;43.68;0.00;28'645.82;USD;28'645.82;214'292.99;USD
15-10-2020 21:19:16;76604926;Verkauf;SQQQ;PROSHARES ULTRAPRO SHORT QQQ E;US74347G8612;2500.0;20.4905;157.97;0.00;51'068.28;USD;51'068.28;185'647.17;USD
15-10-2020 21:19:16;76604926;Verkauf;SQQQ;PROSHARES ULTRAPRO SHORT QQQ E;US74347G8612;1400.0;20.4925;133.66;0.00;28'555.84;USD;28'555.84;134'578.89;USD
15-10-2020 21:19:16;76604926;Verkauf;SQQQ;PROSHARES ULTRAPRO SHORT QQQ E;US74347G8612;2500.0;20.4905;127.97;0.00;51'098.28;USD;51'098.28;106'023.05;USD
15-10-2020 21:19:15;76604926;Verkauf;SQQQ;PROSHARES ULTRAPRO SHORT QQQ E;US74347G8612;1400.0;20.4925;103.68;0.00;28'585.82;USD;28'585.82;54'924.77;USD
15-10-2020 21:19:15;76604926;Verkauf;SQQQ;PROSHARES ULTRAPRO SHORT QQQ E;US74347G8612;400.0;20.495;42.47;0.00;8'155.53;USD;8'155.53;26'338.95;USD
15-10-2020 21:19:15;76604926;Verkauf;SQQQ;PROSHARES ULTRAPRO SHORT QQQ E;US74347G8612;400.0;20.495;52.48;0.00;8'145.52;USD;8'145.52;18'183.42;USD
14-10-2020 16:37:21;76553967;Kauf;SQQQ;PROSHARES ULTRAPRO SHORT QQQ E;US74347G8612;16500.0;19.75;488.82;0.00;-326'363.82;USD;-326'363.82;10'037.90;USD
14-10-2020 16:37:21;76553967;Kauf;SQQQ;PROSHARES ULTRAPRO SHORT QQQ E;US74347G8612;820.0;19.747;24.29;0.00;-16'216.83;USD;-16'216.83;336'401.72;USD
14-10-2020 16:37:21;76553967;Kauf;SQQQ;PROSHARES ULTRAPRO SHORT QQQ E;US74347G8612;2500.0;19.7495;74.06;0.00;-49'447.81;USD;-49'447.81;352'618.55;USD
14-10-2020 16:37:21;76553967;Kauf;SQQQ;PROSHARES ULTRAPRO SHORT QQQ E;US74347G8612;1400.0;19.7475;41.47;0.00;-27'687.97;USD;-27'687.97;402'066.36;USD
14-10-2020 16:37:21;76553967;Kauf;SQQQ;PROSHARES ULTRAPRO SHORT QQQ E;US74347G8612;2500.0;19.747;74.05;0.00;-49'441.55;USD;-49'441.55;429'754.33;USD
14-10-2020 16:37:21;76553967;Kauf;SQQQ;PROSHARES ULTRAPRO SHORT QQQ E;US74347G8612;2500.0;19.7495;154.06;0.00;-49'527.81;USD;-49'527.81;479'195.88;USD
14-10-2020 16:37:20;76553967;Kauf;SQQQ;PROSHARES ULTRAPRO SHORT QQQ E;US74347G8612;1400.0;19.7475;41.47;0.00;-27'687.97;USD;-27'687.97;528'723.69;USD
14-10-2020 16:37:20;76553967;Kauf;SQQQ;PROSHARES ULTRAPRO SHORT QQQ E;US74347G8612;2500.0;19.745;164.04;0.00;-49'526.54;USD;-49'526.54;556'411.66;USD
14-10-2020 16:37:20;76553967;Kauf;SQQQ;PROSHARES ULTRAPRO SHORT QQQ E;US74347G8612;600.0;19.745;67.77;0.00;-11'914.77;USD;-11'914.77;605'938.20;USD
14-10-2020 16:37:20;76553967;Kauf;SQQQ;PROSHARES ULTRAPRO SHORT QQQ E;US74347G8612;80.0;19.745;2.37;0.00;-1'581.97;USD;-1'581.97;617'852.97;USD
14-10-2020 16:37:20;76553967;Kauf;SQQQ;PROSHARES ULTRAPRO SHORT QQQ E;US74347G8612;400.0;19.745;11.85;0.00;-7'909.85;USD;-7'909.85;619'434.94;USD
14-10-2020 16:37:20;76553967;Kauf;SQQQ;PROSHARES ULTRAPRO SHORT QQQ E;US74347G8612;100.0;19.745;2.96;0.00;-1'977.46;USD;-1'977.46;627'344.79;USD
14-10-2020 16:37:19;76553967;Kauf;SQQQ;PROSHARES ULTRAPRO SHORT QQQ E;US74347G8612;100.0;19.745;2.96;0.00;-1'977.46;USD;-1'977.46;629'322.25;USD
14-10-2020 16:37:19;76553967;Kauf;SQQQ;PROSHARES ULTRAPRO SHORT QQQ E;US74347G8612;400.0;19.745;46.85;0.00;-7'944.85;USD;-7'944.85;631'299.71;USD
14-10-2020 16:37:19;76553967;Kauf;SQQQ;PROSHARES ULTRAPRO SHORT QQQ E;US74347G8612;100.0;19.745;2.96;0.00;-1'977.46;USD;-1'977.46;639'244.56;USD
14-10-2020 16:37:19;76553967;Kauf;SQQQ;PROSHARES ULTRAPRO SHORT QQQ E;US74347G8612;600.0;19.745;72.77;0.00;-11'919.77;USD;-11'919.77;641'222.02;USD
14-10-2020 16:37:19;76553967;Kauf;SQQQ;PROSHARES ULTRAPRO SHORT QQQ E;US74347G8612;400.0;19.745;16.85;0.00;-7'914.85;USD;-7'914.85;653'141.79;USD
14-10-2020 16:37:19;76553967;Kauf;SQQQ;PROSHARES ULTRAPRO SHORT QQQ E;US74347G8612;100.0;19.745;37.96;0.00;-2'012.46;USD;-2'012.46;661'056.64;USD
14-10-2020 16:36:03;00000000;Forex-Gutschrift;;;;1.0;54'384.95;0.00;0.00;54'384.95;USD;54'384.95;663'069.10;USD
14-10-2020 16:36:03;00000000;Forex-Belastung;;;;1.0;50'000.00;0.00;0.00;-50'000.00;CHF;-50'000.00;7'809.95;CHF
09-10-2020 18:01:47;76411632;Verkauf;SQQQ;PROSHARES ULTRAPRO SHORT QQQ E;US74347G8612;18900.0;21.79;706.86;0.00;411'124.14;USD;411'124.14;608'684.15;USD
09-10-2020 18:01:47;76411632;Verkauf;SQQQ;PROSHARES ULTRAPRO SHORT QQQ E;US74347G8612;1500.0;21.795;49.76;0.00;32'642.74;USD;32'642.74;197'560.01;USD
09-10-2020 18:01:47;76411632;Verkauf;SQQQ;PROSHARES ULTRAPRO SHORT QQQ E;US74347G8612;800.0;21.7919;116.53;0.00;17'316.99;USD;17'316.99;164'917.27;USD
09-10-2020 18:01:47;76411632;Verkauf;SQQQ;PROSHARES ULTRAPRO SHORT QQQ E;US74347G8612;1600.0;21.7901;53.06;0.00;34'811.10;USD;34'811.10;147'600.28;USD
09-10-2020 18:01:46;76411632;Verkauf;SQQQ;PROSHARES ULTRAPRO SHORT QQQ E;US74347G8612;800.0;21.7919;76.54;0.00;17'356.98;USD;17'356.98;112'789.18;USD
09-10-2020 18:01:46;76411632;Verkauf;SQQQ;PROSHARES ULTRAPRO SHORT QQQ E;US74347G8612;1600.0;21.7901;183.07;0.00;34'681.09;USD;34'681.09;95'432.20;USD
09-10-2020 17:59:12;76411604;Verkauf;SQQQ;PROSHARES ULTRAPRO SHORT QQQ E;US74347G8612;90.0;21.79;2.99;0.00;1'958.11;USD;1'958.11;60'751.11;USD
09-10-2020 17:59:11;76411604;Verkauf;SQQQ;PROSHARES ULTRAPRO SHORT QQQ E;US74347G8612;1.0;21.79;0.04;0.00;21.75;USD;21.75;58'793.00;USD
09-10-2020 17:59:11;76411604;Verkauf;SQQQ;PROSHARES ULTRAPRO SHORT QQQ E;US74347G8612;1509.0;21.79;135.04;0.00;32'746.07;USD;32'746.07;58'771.25;USD
09-10-2020 17:59:11;76411604;Verkauf;SQQQ;PROSHARES ULTRAPRO SHORT QQQ E;US74347G8612;600.0;21.80;64.91;0.00;13'015.09;USD;13'015.09;26'025.18;USD
09-10-2020 17:59:11;76411604;Verkauf;SQQQ;PROSHARES ULTRAPRO SHORT QQQ E;US74347G8612;100.0;21.80;3.32;0.00;2'176.68;USD;2'176.68;13'010.09;USD
09-10-2020 17:59:11;76411604;Verkauf;SQQQ;PROSHARES ULTRAPRO SHORT QQQ E;US74347G8612;500.0;21.80;66.59;0.00;10'833.41;USD;10'833.41;10'833.41;USD
09-09-2020 22:17:06;00000000;Fx-Gutschrift Comp.;;;;1.0;22'569.07;0.00;0.00;22'569.07;USD;22'569.07;0.00;USD
09-09-2020 22:17:06;00000000;Fx-Belastung Comp.;;;;1.0;20'847.23;0.00;0.00;-20'847.23;CHF;-20'847.23;57'809.95;CHF
09-09-2020 15:30:53;75279767;Kauf;SQQQ;PROSHARES ULTRAPRO SHORT QQQ E;US74347G8612;8000.0;25.26;653.12;0.00;-202'733.12;USD;-202'733.12;-22'569.07;USD
08-09-2020 22:29:35;00000000;Einzahlung;;;;1.0;50'000.00;0.00;0.00;50'000.00;CHF;50'000.00;78'657.18;CHF
08-09-2020 17:34:43;75267725;Kauf;SQQQ;PROSHARES ULTRAPRO SHORT QQQ E;US74347G8612;8000.0;25.95;311.40;0.00;-207'911.40;USD;-207'911.40;180'164.05;USD
08-09-2020 17:34:43;75267725;Kauf;SQQQ;PROSHARES ULTRAPRO SHORT QQQ E;US74347G8612;700.0;25.9491;27.24;0.00;-18'191.61;USD;-18'191.61;388'075.45;USD
08-09-2020 17:34:43;75267725;Kauf;SQQQ;PROSHARES ULTRAPRO SHORT QQQ E;US74347G8612;800.0;25.9491;31.14;0.00;-20'790.42;USD;-20'790.42;406'267.06;USD
08-09-2020 17:34:42;75267725;Kauf;SQQQ;PROSHARES ULTRAPRO SHORT QQQ E;US74347G8612;800.0;25.9491;31.14;0.00;-20'790.42;USD;-20'790.42;427'057.48;USD
08-09-2020 17:34:42;75267725;Kauf;SQQQ;PROSHARES ULTRAPRO SHORT QQQ E;US74347G8612;800.0;25.9491;31.14;0.00;-20'790.42;USD;-20'790.42;447'847.90;USD
08-09-2020 17:34:42;75267725;Kauf;SQQQ;PROSHARES ULTRAPRO SHORT QQQ E;US74347G8612;800.0;25.9491;31.14;0.00;-20'790.42;USD;-20'790.42;468'638.32;USD
08-09-2020 17:34:42;75267725;Kauf;SQQQ;PROSHARES ULTRAPRO SHORT QQQ E;US74347G8612;800.0;25.9491;31.14;0.00;-20'790.42;USD;-20'790.42;489'428.74;USD
08-09-2020 17:34:42;75267725;Kauf;SQQQ;PROSHARES ULTRAPRO SHORT QQQ E;US74347G8612;800.0;25.9491;31.14;0.00;-20'790.42;USD;-20'790.42;510'219.16;USD
08-09-2020 17:34:42;75267725;Kauf;SQQQ;PROSHARES ULTRAPRO SHORT QQQ E;US74347G8612;500.0;25.95;19.46;0.00;-12'994.46;USD;-12'994.46;531'009.58;USD
08-09-2020 17:34:41;75267725;Kauf;SQQQ;PROSHARES ULTRAPRO SHORT QQQ E;US74347G8612;100.0;25.95;3.89;0.00;-2'598.89;USD;-2'598.89;544'004.04;USD
08-09-2020 17:34:41;75267725;Kauf;SQQQ;PROSHARES ULTRAPRO SHORT QQQ E;US74347G8612;100.0;25.95;3.89;0.00;-2'598.89;USD;-2'598.89;546'602.93;USD
08-09-2020 17:34:41;75267725;Kauf;SQQQ;PROSHARES ULTRAPRO SHORT QQQ E;US74347G8612;100.0;25.95;83.90;0.00;-2'678.90;USD;-2'678.90;549'201.82;USD
08-09-2020 17:34:41;75267725;Kauf;SQQQ;PROSHARES ULTRAPRO SHORT QQQ E;US74347G8612;100.0;25.95;3.89;0.00;-2'598.89;USD;-2'598.89;551'880.72;USD
08-09-2020 17:34:41;75267725;Kauf;SQQQ;PROSHARES ULTRAPRO SHORT QQQ E;US74347G8612;200.0;25.95;7.78;0.00;-5'197.78;USD;-5'197.78;554'479.61;USD
08-09-2020 17:34:41;75267725;Kauf;SQQQ;PROSHARES ULTRAPRO SHORT QQQ E;US74347G8612;100.0;25.95;3.90;0.00;-2'598.90;USD;-2'598.90;559'677.39;USD
08-09-2020 17:34:40;75267725;Kauf;SQQQ;PROSHARES ULTRAPRO SHORT QQQ E;US74347G8612;100.0;25.95;3.89;0.00;-2'598.89;USD;-2'598.89;562'276.29;USD
08-09-2020 17:34:40;75267725;Kauf;SQQQ;PROSHARES ULTRAPRO SHORT QQQ E;US74347G8612;700.0;25.95;27.25;0.00;-18'192.25;USD;-18'192.25;564'875.18;USD
08-09-2020 17:34:40;75267725;Kauf;SQQQ;PROSHARES ULTRAPRO SHORT QQQ E;US74347G8612;100.0;25.95;3.89;0.00;-2'598.89;USD;-2'598.89;583'067.43;USD
08-09-2020 17:34:40;75267725;Kauf;SQQQ;PROSHARES ULTRAPRO SHORT QQQ E;US74347G8612;100.0;25.95;3.89;0.00;-2'598.89;USD;-2'598.89;585'666.32;USD
08-09-2020 17:34:40;75267725;Kauf;SQQQ;PROSHARES ULTRAPRO SHORT QQQ E;US74347G8612;1000.0;25.95;128.93;0.00;-26'078.93;USD;-26'078.93;588'265.21;USD
08-09-2020 17:34:39;75267725;Kauf;SQQQ;PROSHARES ULTRAPRO SHORT QQQ E;US74347G8612;100.0;25.95;3.89;0.00;-2'598.89;USD;-2'598.89;614'344.14;USD
08-09-2020 17:34:39;75267725;Kauf;SQQQ;PROSHARES ULTRAPRO SHORT QQQ E;US74347G8612;100.0;25.95;3.89;0.00;-2'598.89;USD;-2'598.89;616'943.03;USD
08-09-2020 17:34:39;75267725;Kauf;SQQQ;PROSHARES ULTRAPRO SHORT QQQ E;US74347G8612;100.0;25.95;3.89;0.00;-2'598.89;USD;-2'598.89;619'541.92;USD
08-09-2020 17:34:39;75267725;Kauf;SQQQ;PROSHARES ULTRAPRO SHORT QQQ E;US74347G8612;100.0;25.95;3.90;0.00;-2'598.90;USD;-2'598.90;622'140.81;USD
08-09-2020 17:34:39;75267725;Kauf;SQQQ;PROSHARES ULTRAPRO SHORT QQQ E;US74347G8612;900.0;25.95;35.03;0.00;-23'390.03;USD;-23'390.03;624'739.71;USD
08-09-2020 17:34:39;75267725;Kauf;SQQQ;PROSHARES ULTRAPRO SHORT QQQ E;US74347G8612;200.0;25.95;57.78;0.00;-5'247.78;USD;-5'247.78;648'129.74;USD
08-09-2020 17:34:39;75267725;Kauf;SQQQ;PROSHARES ULTRAPRO SHORT QQQ E;US74347G8612;100.0;25.95;3.90;0.00;-2'598.90;USD;-2'598.90;653'377.52;USD
08-09-2020 17:34:38;75267725;Kauf;SQQQ;PROSHARES ULTRAPRO SHORT QQQ E;US74347G8612;100.0;25.95;3.89;0.00;-2'598.89;USD;-2'598.89;655'976.42;USD
08-09-2020 17:34:38;75267725;Kauf;SQQQ;PROSHARES ULTRAPRO SHORT QQQ E;US74347G8612;1300.0;25.95;140.60;0.00;-33'875.60;USD;-33'875.60;658'575.31;USD
08-09-2020 17:34:38;75267725;Kauf;SQQQ;PROSHARES ULTRAPRO SHORT QQQ E;US74347G8612;100.0;25.95;3.89;0.00;-2'598.89;USD;-2'598.89;692'450.91;USD
08-09-2020 17:34:38;75267725;Kauf;SQQQ;PROSHARES ULTRAPRO SHORT QQQ E;US74347G8612;200.0;25.95;47.79;0.00;-5'237.79;USD;-5'237.79;695'049.80;USD
08-09-2020 16:26:08;75232861;Verkauf;SQQQ;PROSHARES ULTRAPRO SHORT QQQ E;US74347G8612;778.0;25.04;29.65;0.00;19'451.47;USD;19'451.47;700'287.59;USD
08-09-2020 16:26:07;75232861;Verkauf;SQQQ;PROSHARES ULTRAPRO SHORT QQQ E;US74347G8612;100.0;25.04;3.81;0.00;2'500.19;USD;2'500.19;680'836.12;USD
08-09-2020 16:26:07;75232861;Verkauf;SQQQ;PROSHARES ULTRAPRO SHORT QQQ E;US74347G8612;100.0;25.04;3.81;0.00;2'500.19;USD;2'500.19;678'335.93;USD
08-09-2020 16:26:07;75232861;Verkauf;SQQQ;PROSHARES ULTRAPRO SHORT QQQ E;US74347G8612;100.0;25.04;3.81;0.00;2'500.19;USD;2'500.19;675'835.74;USD
08-09-2020 16:26:07;75232861;Verkauf;SQQQ;PROSHARES ULTRAPRO SHORT QQQ E;US74347G8612;500.0;25.04;19.06;0.00;12'500.94;USD;12'500.94;673'335.55;USD
08-09-2020 16:26:07;75232861;Verkauf;SQQQ;PROSHARES ULTRAPRO SHORT QQQ E;US74347G8612;1500.0;25.04;57.17;0.00;37'502.83;USD;37'502.83;660'834.61;USD
08-09-2020 16:26:06;75232861;Verkauf;SQQQ;PROSHARES ULTRAPRO SHORT QQQ E;US74347G8612;300.0;25.04;11.43;0.00;7'500.57;USD;7'500.57;623'331.78;USD
08-09-2020 16:26:06;75232861;Verkauf;SQQQ;PROSHARES ULTRAPRO SHORT QQQ E;US74347G8612;100.0;25.04;3.81;0.00;2'500.19;USD;2'500.19;615'831.21;USD
08-09-2020 16:26:06;75232861;Verkauf;SQQQ;PROSHARES ULTRAPRO SHORT QQQ E;US74347G8612;1800.0;25.04;68.61;0.00;45'003.39;USD;45'003.39;613'331.02;USD
08-09-2020 16:26:06;75232861;Verkauf;SQQQ;PROSHARES ULTRAPRO SHORT QQQ E;US74347G8612;100.0;25.04;3.81;0.00;2'500.19;USD;2'500.19;568'327.63;USD
08-09-2020 16:26:06;75232861;Verkauf;SQQQ;PROSHARES ULTRAPRO SHORT QQQ E;US74347G8612;1500.0;25.04;57.17;0.00;37'502.83;USD;37'502.83;565'827.44;USD
08-09-2020 16:26:05;75232861;Verkauf;SQQQ;PROSHARES ULTRAPRO SHORT QQQ E;US74347G8612;100.0;25.04;3.81;0.00;2'500.19;USD;2'500.19;528'324.61;USD
08-09-2020 16:26:05;75232861;Verkauf;SQQQ;PROSHARES ULTRAPRO SHORT QQQ E;US74347G8612;5500.0;25.04;209.62;0.00;137'510.38;USD;137'510.38;525'824.42;USD
08-09-2020 16:26:05;75232861;Verkauf;SQQQ;PROSHARES ULTRAPRO SHORT QQQ E;US74347G8612;3.0;25.04;0.12;0.00;75.00;USD;75.00;388'314.04;USD
08-09-2020 16:26:05;75232861;Verkauf;SQQQ;PROSHARES ULTRAPRO SHORT QQQ E;US74347G8612;100.0;25.04;3.81;0.00;2'500.19;USD;2'500.19;388'239.04;USD
08-09-2020 16:26:04;75232861;Verkauf;SQQQ;PROSHARES ULTRAPRO SHORT QQQ E;US74347G8612;110.0;25.04;4.19;0.00;2'750.21;USD;2'750.21;385'738.85;USD
08-09-2020 16:26:04;75232861;Verkauf;SQQQ;PROSHARES ULTRAPRO SHORT QQQ E;US74347G8612;800.0;25.04;30.49;0.00;20'001.51;USD;20'001.51;382'988.64;USD
08-09-2020 16:26:04;75232861;Verkauf;SQQQ;PROSHARES ULTRAPRO SHORT QQQ E;US74347G8612;10.0;25.04;0.39;0.00;250.01;USD;250.01;362'987.13;USD
08-09-2020 16:26:04;75232861;Verkauf;SQQQ;PROSHARES ULTRAPRO SHORT QQQ E;US74347G8612;5400.0;25.04;205.80;0.00;135'010.20;USD;135'010.20;362'737.12;USD
08-09-2020 16:26:04;75232861;Verkauf;SQQQ;PROSHARES ULTRAPRO SHORT QQQ E;US74347G8612;9.0;25.04;0.35;0.00;225.01;USD;225.01;227'726.92;USD
08-09-2020 16:26:03;75232861;Verkauf;SQQQ;PROSHARES ULTRAPRO SHORT QQQ E;US74347G8612;1500.0;25.04;137.17;0.00;37'422.83;USD;37'422.83;227'501.91;USD
08-09-2020 16:26:03;75232861;Verkauf;SQQQ;PROSHARES ULTRAPRO SHORT QQQ E;US74347G8612;90.0;25.04;3.43;0.00;2'250.17;USD;2'250.17;190'079.08;USD
08-09-2020 16:26:03;75232861;Verkauf;SQQQ;PROSHARES ULTRAPRO SHORT QQQ E;US74347G8612;4500.0;25.04;441.51;0.00;112'238.49;USD;112'238.49;187'828.91;USD
08-09-2020 15:31:33;75203867;Kauf;SQQQ;PROSHARES ULTRAPRO SHORT QQQ E;US74347G8612;25000.0;26.35;1'338.13;0.00;-660'088.13;USD;-660'088.13;75'590.42;USD
04-09-2020 21:11:49;75152566;Verkauf;SQQQ;PROSHARES ULTRAPRO SHORT QQQ E;US74347G8612;15000.0;23.22;530.15;0.00;347'769.85;USD;347'769.85;735'678.55;USD
04-09-2020 21:11:49;75152566;Verkauf;SQQQ;PROSHARES ULTRAPRO SHORT QQQ E;US74347G8612;420.0;23.2225;14.85;0.00;9'738.60;USD;9'738.60;387'908.70;USD
04-09-2020 21:11:49;75152566;Verkauf;SQQQ;PROSHARES ULTRAPRO SHORT QQQ E;US74347G8612;1400.0;23.2225;49.48;0.00;32'462.02;USD;32'462.02;378'170.10;USD
04-09-2020 21:11:49;75152566;Verkauf;SQQQ;PROSHARES ULTRAPRO SHORT QQQ E;US74347G8612;2500.0;23.2201;88.36;0.00;57'961.89;USD;57'961.89;345'708.08;USD
04-09-2020 21:11:49;75152566;Verkauf;SQQQ;PROSHARES ULTRAPRO SHORT QQQ E;US74347G8612;1400.0;23.2225;49.49;0.00;32'462.01;USD;32'462.01;287'746.19;USD
04-09-2020 21:11:49;75152566;Verkauf;SQQQ;PROSHARES ULTRAPRO SHORT QQQ E;US74347G8612;2500.0;23.2201;88.35;0.00;57'961.90;USD;57'961.90;255'284.18;USD
04-09-2020 21:11:48;75152566;Verkauf;SQQQ;PROSHARES ULTRAPRO SHORT QQQ E;US74347G8612;400.0;23.223;94.14;0.00;9'195.06;USD;9'195.06;197'322.28;USD
04-09-2020 21:11:48;75152566;Verkauf;SQQQ;PROSHARES ULTRAPRO SHORT QQQ E;US74347G8612;2500.0;23.225;178.38;0.00;57'884.12;USD;57'884.12;188'127.22;USD
04-09-2020 21:11:48;75152566;Verkauf;SQQQ;PROSHARES ULTRAPRO SHORT QQQ E;US74347G8612;1400.0;23.2225;49.49;0.00;32'462.01;USD;32'462.01;130'243.10;USD
04-09-2020 21:11:48;75152566;Verkauf;SQQQ;PROSHARES ULTRAPRO SHORT QQQ E;US74347G8612;300.0;23.225;10.60;0.00;6'956.90;USD;6'956.90;97'781.09;USD
04-09-2020 21:11:48;75152566;Verkauf;SQQQ;PROSHARES ULTRAPRO SHORT QQQ E;US74347G8612;200.0;23.225;57.06;0.00;4'587.94;USD;4'587.94;90'824.19;USD
04-09-2020 21:11:48;75152566;Verkauf;SQQQ;PROSHARES ULTRAPRO SHORT QQQ E;US74347G8612;200.0;23.225;7.08;0.00;4'637.92;USD;4'637.92;86'236.25;USD
04-09-2020 21:11:47;75152566;Verkauf;SQQQ;PROSHARES ULTRAPRO SHORT QQQ E;US74347G8612;200.0;23.225;7.07;0.00;4'637.93;USD;4'637.93;81'598.33;USD
04-09-2020 21:11:47;75152566;Verkauf;SQQQ;PROSHARES ULTRAPRO SHORT QQQ E;US74347G8612;200.0;23.225;7.07;0.00;4'637.93;USD;4'637.93;76'960.40;USD
04-09-2020 21:11:47;75152566;Verkauf;SQQQ;PROSHARES ULTRAPRO SHORT QQQ E;US74347G8612;200.0;23.225;42.06;0.00;4'602.94;USD;4'602.94;72'322.47;USD
04-09-2020 21:11:47;75152566;Verkauf;SQQQ;PROSHARES ULTRAPRO SHORT QQQ E;US74347G8612;200.0;23.225;7.08;0.00;4'637.92;USD;4'637.92;67'719.53;USD
04-09-2020 21:11:47;75152566;Verkauf;SQQQ;PROSHARES ULTRAPRO SHORT QQQ E;US74347G8612;100.0;23.23;3.54;0.00;2'319.46;USD;2'319.46;63'081.61;USD
04-09-2020 21:11:47;75152566;Verkauf;SQQQ;PROSHARES ULTRAPRO SHORT QQQ E;US74347G8612;100.0;23.23;28.53;0.00;2'294.47;USD;2'294.47;60'762.15;USD
04-09-2020 21:11:46;75152566;Verkauf;SQQQ;PROSHARES ULTRAPRO SHORT QQQ E;US74347G8612;200.0;23.23;27.07;0.00;4'618.93;USD;4'618.93;58'467.68;USD
04-09-2020 21:11:46;75152566;Verkauf;SQQQ;PROSHARES ULTRAPRO SHORT QQQ E;US74347G8612;100.0;23.23;3.53;0.00;2'319.47;USD;2'319.47;53'848.75;USD
04-09-2020 21:11:46;75152566;Verkauf;SQQQ;PROSHARES ULTRAPRO SHORT QQQ E;US74347G8612;180.0;23.23;16.38;0.00;4'165.02;USD;4'165.02;51'529.28;USD
04-09-2020 21:11:46;75152566;Verkauf;SQQQ;PROSHARES ULTRAPRO SHORT QQQ E;US74347G8612;200.0;23.23;12.07;0.00;4'633.93;USD;4'633.93;47'364.26;USD
04-09-2020 21:11:46;75152566;Verkauf;SQQQ;PROSHARES ULTRAPRO SHORT QQQ E;US74347G8612;100.0;23.23;38.53;0.00;2'284.47;USD;2'284.47;42'730.33;USD
03-09-2020 18:19:57;75084203;Kauf;SQQQ;PROSHARES ULTRAPRO SHORT QQQ E;US74347G8612;14625.0;22.19;566.79;0.00;-325'095.54;USD;-325'095.54;40'445.86;USD
03-09-2020 18:19:57;75084203;Kauf;SQQQ;PROSHARES ULTRAPRO SHORT QQQ E;US74347G8612;175.0;22.19;5.82;0.00;-3'889.07;USD;-3'889.07;365'541.40;USD
03-09-2020 18:19:57;75084203;Kauf;SQQQ;PROSHARES ULTRAPRO SHORT QQQ E;US74347G8612;1200.0;22.19;129.95;0.00;-26'757.95;USD;-26'757.95;369'430.47;USD
03-09-2020 18:19:54;75084203;Kauf;SQQQ;PROSHARES ULTRAPRO SHORT QQQ E;US74347G8612;100.0;22.19;3.32;0.00;-2'222.32;USD;-2'222.32;396'188.42;USD
03-09-2020 18:19:53;75084203;Kauf;SQQQ;PROSHARES ULTRAPRO SHORT QQQ E;US74347G8612;2200.0;22.19;158.23;0.00;-48'976.23;USD;-48'976.23;398'410.74;USD
03-09-2020 18:19:52;75084203;Kauf;SQQQ;PROSHARES ULTRAPRO SHORT QQQ E;US74347G8612;600.0;22.19;64.97;0.00;-13'378.97;USD;-13'378.97;447'386.97;USD
03-09-2020 18:19:51;75084203;Kauf;SQQQ;PROSHARES ULTRAPRO SHORT QQQ E;US74347G8612;600.0;22.187;69.97;0.00;-13'382.17;USD;-13'382.17;460'765.94;USD
03-09-2020 18:17:39;75083572;Kauf;SQQQ;PROSHARES ULTRAPRO SHORT QQQ E;US74347G8612;7500.0;22.25;420.31;0.00;-167'295.31;USD;-167'295.31;474'148.11;USD
03-09-2020 18:17:36;75083572;Kauf;SQQQ;PROSHARES ULTRAPRO SHORT QQQ E;US74347G8612;1600.0;22.25;138.40;0.00;-35'738.40;USD;-35'738.40;641'443.42;USD
03-09-2020 18:17:36;75083572;Kauf;SQQQ;PROSHARES ULTRAPRO SHORT QQQ E;US74347G8612;600.0;22.25;75.03;0.00;-13'425.03;USD;-13'425.03;677'181.82;USD
03-09-2020 18:17:36;75083572;Kauf;SQQQ;PROSHARES ULTRAPRO SHORT QQQ E;US74347G8612;300.0;22.25;50.01;0.00;-6'725.01;USD;-6'725.01;690'606.85;USD
03-09-2020 18:10:25;00000000;Forex-Gutschrift;;;;1.0;599'585.80;0.00;0.00;599'585.80;USD;599'585.80;697'331.86;USD
03-09-2020 18:10:25;00000000;Forex-Belastung;;;;1.0;550'000.00;0.00;0.00;-550'000.00;CHF;-550'000.00;28'657.18;CHF
03-09-2020 18:07:00;75083424;Kauf;SQQQ;PROSHARES ULTRAPRO SHORT QQQ E;US74347G8612;500.0;22.32;66.74;0.00;-11'226.74;USD;-11'226.74;97'746.06;USD
03-09-2020 18:05:30;00000000;Forex-Gutschrift;;;;1.0;108'972.80;0.00;0.00;108'972.80;USD;108'972.80;108'972.80;USD
03-09-2020 18:05:30;00000000;Forex-Belastung;;;;1.0;100'000.00;0.00;0.00;-100'000.00;CHF;-100'000.00;578'657.18;CHF
03-09-2020 18:04:03;00000000;Einzahlung;;;;1.0;100'000.00;0.00;0.00;100'000.00;CHF;100'000.00;678'657.18;CHF
28-07-2020 16:03:30;00000000;Forex-Gutschrift;;;;1.0;575'373.50;0.00;0.00;575'373.50;CHF;575'373.50;578'657.18;CHF
28-07-2020 16:03:30;00000000;Forex-Belastung;;;;1.0;632'927.50;0.00;0.00;-632'927.50;USD;-632'927.50;0.00;USD
01-07-2020 19:02:52;00000000;Spesen Steuerauszug;;;;1.0;-96.93;0.00;0.00;-96.93;CHF;-96.93;3'283.68;CHF
11-05-2020 15:38:19;71273654;Berichtigung Börsengeb.;SOXL;DIREXION SEMICONDUCTOR BULL 3X;US25459W4583;1.0;-0.75;0.00;0.00;-0.75;USD;-0.75;632'927.50;USD
11-05-2020 15:30:21;71273654;Verkauf;SOXL;DIREXION SEMICONDUCTOR BULL 3X;US25459W4583;803.0;134.44;164.16;0.00;107'791.16;USD;107'791.16;632'928.25;USD
11-05-2020 15:30:21;71273654;Verkauf;SOXL;DIREXION SEMICONDUCTOR BULL 3X;US25459W4583;20.0;134.44;4.10;0.00;2'684.70;USD;2'684.70;525'137.09;USD
11-05-2020 15:30:21;71273654;Verkauf;SOXL;DIREXION SEMICONDUCTOR BULL 3X;US25459W4583;10.0;134.44;2.04;0.00;1'342.36;USD;1'342.36;522'452.39;USD
11-05-2020 15:30:20;71273654;Verkauf;SOXL;DIREXION SEMICONDUCTOR BULL 3X;US25459W4583;1.0;134.44;0.20;0.00;134.24;USD;134.24;521'110.03;USD
11-05-2020 15:30:20;71273654;Verkauf;SOXL;DIREXION SEMICONDUCTOR BULL 3X;US25459W4583;1.0;134.44;0.21;0.00;134.23;USD;134.23;520'975.79;USD
11-05-2020 15:30:20;71273654;Verkauf;SOXL;DIREXION SEMICONDUCTOR BULL 3X;US25459W4583;10.0;134.44;2.04;0.00;1'342.36;USD;1'342.36;520'841.56;USD
11-05-2020 15:30:20;71273654;Verkauf;SOXL;DIREXION SEMICONDUCTOR BULL 3X;US25459W4583;2.0;134.44;0.42;0.00;268.46;USD;268.46;519'499.20;USD
11-05-2020 15:30:20;71273654;Verkauf;SOXL;DIREXION SEMICONDUCTOR BULL 3X;US25459W4583;1.0;134.44;0.20;0.00;134.24;USD;134.24;519'230.74;USD
11-05-2020 15:30:20;71273654;Verkauf;SOXL;DIREXION SEMICONDUCTOR BULL 3X;US25459W4583;1.0;134.44;0.20;0.00;134.24;USD;134.24;519'096.50;USD
11-05-2020 15:30:19;71273654;Verkauf;SOXL;DIREXION SEMICONDUCTOR BULL 3X;US25459W4583;7.0;134.44;1.43;0.00;939.65;USD;939.65;518'962.26;USD
11-05-2020 15:30:19;71273654;Verkauf;SOXL;DIREXION SEMICONDUCTOR BULL 3X;US25459W4583;1.0;134.44;0.20;0.00;134.24;USD;134.24;518'022.61;USD
11-05-2020 15:30:19;71273654;Verkauf;SOXL;DIREXION SEMICONDUCTOR BULL 3X;US25459W4583;5.0;134.44;1.03;0.00;671.17;USD;671.17;517'888.37;USD
11-05-2020 15:30:19;71273654;Verkauf;SOXL;DIREXION SEMICONDUCTOR BULL 3X;US25459W4583;5.0;134.44;1.02;0.00;671.18;USD;671.18;517'217.20;USD
11-05-2020 15:30:19;71273654;Verkauf;SOXL;DIREXION SEMICONDUCTOR BULL 3X;US25459W4583;1.0;134.44;0.20;0.00;134.24;USD;134.24;516'546.02;USD
11-05-2020 15:30:18;71273654;Verkauf;SOXL;DIREXION SEMICONDUCTOR BULL 3X;US25459W4583;5.0;134.44;1.03;0.00;671.17;USD;671.17;516'411.78;USD
11-05-2020 15:30:18;71273654;Verkauf;SOXL;DIREXION SEMICONDUCTOR BULL 3X;US25459W4583;1.0;134.44;0.20;0.00;134.24;USD;134.24;515'740.61;USD
11-05-2020 15:30:18;71273654;Verkauf;SOXL;DIREXION SEMICONDUCTOR BULL 3X;US25459W4583;3.0;134.44;0.62;0.00;402.70;USD;402.70;515'606.37;USD
11-05-2020 15:30:18;71273654;Verkauf;SOXL;DIREXION SEMICONDUCTOR BULL 3X;US25459W4583;1.0;134.44;0.20;0.00;134.24;USD;134.24;515'203.67;USD
11-05-2020 15:30:18;71273654;Verkauf;SOXL;DIREXION SEMICONDUCTOR BULL 3X;US25459W4583;1.0;134.44;0.20;0.00;134.24;USD;134.24;515'069.43;USD
11-05-2020 15:30:17;71273654;Verkauf;SOXL;DIREXION SEMICONDUCTOR BULL 3X;US25459W4583;1.0;134.44;0.21;0.00;134.23;USD;134.23;514'935.19;USD
11-05-2020 15:30:17;71273654;Verkauf;SOXL;DIREXION SEMICONDUCTOR BULL 3X;US25459W4583;1.0;134.44;0.20;0.00;134.24;USD;134.24;514'800.96;USD
11-05-2020 15:30:17;71273654;Verkauf;SOXL;DIREXION SEMICONDUCTOR BULL 3X;US25459W4583;3.0;134.44;0.62;0.00;402.70;USD;402.70;514'666.72;USD
11-05-2020 15:30:17;71273654;Verkauf;SOXL;DIREXION SEMICONDUCTOR BULL 3X;US25459W4583;3.0;134.44;0.61;0.00;402.71;USD;402.71;514'264.02;USD
11-05-2020 15:30:17;71273654;Verkauf;SOXL;DIREXION SEMICONDUCTOR BULL 3X;US25459W4583;2.0;134.44;0.41;0.00;268.47;USD;268.47;513'861.31;USD
11-05-2020 15:30:17;71273654;Verkauf;SOXL;DIREXION SEMICONDUCTOR BULL 3X;US25459W4583;2.0;134.44;0.41;0.00;268.47;USD;268.47;513'592.84;USD
11-05-2020 15:30:16;71273654;Verkauf;SOXL;DIREXION SEMICONDUCTOR BULL 3X;US25459W4583;3.0;134.44;0.61;0.00;402.71;USD;402.71;513'324.37;USD
11-05-2020 15:30:16;71273654;Verkauf;SOXL;DIREXION SEMICONDUCTOR BULL 3X;US25459W4583;3.0;134.44;0.61;0.00;402.71;USD;402.71;512'921.66;USD
11-05-2020 15:30:16;71273654;Verkauf;SOXL;DIREXION SEMICONDUCTOR BULL 3X;US25459W4583;1.0;134.44;0.21;0.00;134.23;USD;134.23;512'518.95;USD
11-05-2020 15:30:16;71273654;Verkauf;SOXL;DIREXION SEMICONDUCTOR BULL 3X;US25459W4583;84.0;134.44;17.17;0.00;11'275.79;USD;11'275.79;512'384.72;USD
11-05-2020 15:30:16;71273654;Verkauf;SOXL;DIREXION SEMICONDUCTOR BULL 3X;US25459W4583;4.0;134.44;0.82;0.00;536.94;USD;536.94;501'108.93;USD
11-05-2020 15:30:16;71273654;Verkauf;SOXL;DIREXION SEMICONDUCTOR BULL 3X;US25459W4583;20.0;134.44;4.09;0.00;2'684.71;USD;2'684.71;500'571.99;USD
11-05-2020 15:30:15;71273654;Verkauf;SOXL;DIREXION SEMICONDUCTOR BULL 3X;US25459W4583;1.0;134.44;0.20;0.00;134.24;USD;134.24;497'887.28;USD
11-05-2020 15:30:15;71273654;Verkauf;SOXL;DIREXION SEMICONDUCTOR BULL 3X;US25459W4583;50.0;134.44;10.22;0.00;6'711.78;USD;6'711.78;497'753.04;USD
11-05-2020 15:30:15;71273654;Verkauf;SOXL;DIREXION SEMICONDUCTOR BULL 3X;US25459W4583;40.0;134.44;8.18;0.00;5'369.42;USD;5'369.42;491'041.26;USD
11-05-2020 15:30:15;71273654;Verkauf;SOXL;DIREXION SEMICONDUCTOR BULL 3X;US25459W4583;50.0;134.44;10.22;0.00;6'711.78;USD;6'711.78;485'671.84;USD
11-05-2020 15:30:15;71273654;Verkauf;SOXL;DIREXION SEMICONDUCTOR BULL 3X;US25459W4583;2.0;134.44;0.42;0.00;268.46;USD;268.46;478'960.06;USD
11-05-2020 15:30:14;71273654;Verkauf;SOXL;DIREXION SEMICONDUCTOR BULL 3X;US25459W4583;1.0;134.44;0.20;0.00;134.24;USD;134.24;478'691.60;USD
11-05-2020 15:30:14;71273654;Verkauf;SOXL;DIREXION SEMICONDUCTOR BULL 3X;US25459W4583;200.0;134.44;40.89;0.00;26'847.11;USD;26'847.11;478'557.36;USD
11-05-2020 15:30:14;71273654;Verkauf;SOXL;DIREXION SEMICONDUCTOR BULL 3X;US25459W4583;50.0;134.44;10.21;0.00;6'711.79;USD;6'711.79;451'710.25;USD
11-05-2020 15:30:14;71273654;Verkauf;SOXL;DIREXION SEMICONDUCTOR BULL 3X;US25459W4583;1000.0;134.44;204.45;0.00;134'235.55;USD;134'235.55;444'998.46;USD
11-05-2020 15:30:14;71273654;Verkauf;SOXL;DIREXION SEMICONDUCTOR BULL 3X;US25459W4583;51.0;134.44;10.43;0.00;6'846.01;USD;6'846.01;310'762.91;USD
11-05-2020 15:30:14;71273654;Verkauf;SOXL;DIREXION SEMICONDUCTOR BULL 3X;US25459W4583;89.0;134.44;18.20;0.00;11'946.96;USD;11'946.96;303'916.90;USD
11-05-2020 15:30:13;71273654;Verkauf;SOXL;DIREXION SEMICONDUCTOR BULL 3X;US25459W4583;58.0;134.44;11.85;0.00;7'785.67;USD;7'785.67;291'969.94;USD
11-05-2020 15:30:13;71273654;Verkauf;SOXL;DIREXION SEMICONDUCTOR BULL 3X;US25459W4583;100.0;134.44;20.45;0.00;13'423.55;USD;13'423.55;284'184.27;USD
11-05-2020 15:30:13;71273654;Verkauf;SOXL;DIREXION SEMICONDUCTOR BULL 3X;US25459W4583;119.0;134.44;24.33;0.00;15'974.03;USD;15'974.03;270'760.72;USD
11-05-2020 15:30:13;71273654;Verkauf;SOXL;DIREXION SEMICONDUCTOR BULL 3X;US25459W4583;100.0;134.44;100.44;0.00;13'343.56;USD;13'343.56;254'786.69;USD
11-05-2020 15:30:13;71273654;Verkauf;SOXL;DIREXION SEMICONDUCTOR BULL 3X;US25459W4583;1048.0;134.44;449.25;0.00;140'443.87;USD;140'443.87;241'443.13;USD
11-05-2020 15:30:12;71273654;Verkauf;SOXL;DIREXION SEMICONDUCTOR BULL 3X;US25459W4583;35.0;134.44;42.16;0.00;4'663.24;USD;4'663.24;100'999.26;USD
29-04-2020 16:46:11;00000000;Forex-Gutschrift;;;;1.0;458'785.35;0.00;0.00;458'785.35;USD;458'785.35;96'336.02;USD
29-04-2020 16:46:11;00000000;Forex-Belastung;;;;1.0;450'000.00;0.00;0.00;-450'000.00;CHF;-450'000.00;3'380.61;CHF
29-04-2020 16:44:42;70903968;Kauf;SOXL;DIREXION SEMICONDUCTOR BULL 3X;US25459W4583;1300.0;140.60;274.17;0.00;-183'054.17;USD;-183'054.17;-362'449.33;USD
29-04-2020 16:44:42;70903968;Kauf;SOXL;DIREXION SEMICONDUCTOR BULL 3X;US25459W4583;100.0;140.567;21.09;0.00;-14'077.79;USD;-14'077.79;-179'395.16;USD
29-04-2020 16:44:42;70903968;Kauf;SOXL;DIREXION SEMICONDUCTOR BULL 3X;US25459W4583;200.0;140.567;42.17;0.00;-28'155.57;USD;-28'155.57;-165'317.37;USD
29-04-2020 16:44:41;70903968;Kauf;SOXL;DIREXION SEMICONDUCTOR BULL 3X;US25459W4583;200.0;140.567;42.17;0.00;-28'155.57;USD;-28'155.57;-137'161.80;USD
29-04-2020 16:44:41;70903968;Kauf;SOXL;DIREXION SEMICONDUCTOR BULL 3X;US25459W4583;200.0;140.567;42.17;0.00;-28'155.57;USD;-28'155.57;-109'006.23;USD
29-04-2020 16:44:41;70903968;Kauf;SOXL;DIREXION SEMICONDUCTOR BULL 3X;US25459W4583;200.0;140.567;42.17;0.00;-28'155.57;USD;-28'155.57;-80'850.66;USD
29-04-2020 16:44:41;70903968;Kauf;SOXL;DIREXION SEMICONDUCTOR BULL 3X;US25459W4583;500.0;140.61;105.45;0.00;-70'410.45;USD;-70'410.45;-52'695.09;USD
29-04-2020 16:44:41;70903968;Kauf;SOXL;DIREXION SEMICONDUCTOR BULL 3X;US25459W4583;1100.0;140.61;487.01;0.00;-155'158.01;USD;-155'158.01;17'715.36;USD
29-04-2020 16:44:40;70903968;Kauf;SOXL;DIREXION SEMICONDUCTOR BULL 3X;US25459W4583;100.0;140.60;66.09;0.00;-14'126.09;USD;-14'126.09;172'873.37;USD
29-04-2020 16:44:40;70903968;Kauf;SOXL;DIREXION SEMICONDUCTOR BULL 3X;US25459W4583;100.0;140.59;71.09;0.00;-14'130.09;USD;-14'130.09;186'999.46;USD
20-04-2020 14:40:42;70542843;Kosten für titel;;;;1.0;0;100.00;0.00;-100.00;CHF;-100.00;453'380.61;CHF
20-04-2020 14:40:42;70542843;Titelausgang;ZUEHLKE TECHNOL;ZUEHLKE TECHNOL-NAMENAKT;CH0011741458;243.0;2'128.90;0.00;0.00;-;CHF;-;0.00;CHF
20-04-2020 14:40:42;70542843;Kosten für titel;;;;1.0;0;7.70;0.00;-7.70;CHF;-7.70;453'480.61;CHF
31-03-2020 21:43:25;69847460;Berichtigung Börsengeb.;SOXL;DIREXION SEMICONDUCTOR BULL 3X;US25459W4583;1.0;-0.20;0.00;0.00;-0.20;USD;-0.20;201'129.55;USD
31-03-2020 21:43:16;69847460;Verkauf;SOXL;DIREXION SEMICONDUCTOR BULL 3X;US25459W4583;300.0;94.45;43.08;0.00;28'291.92;USD;28'291.92;201'129.75;USD
31-03-2020 21:43:16;69847460;Verkauf;SOXL;DIREXION SEMICONDUCTOR BULL 3X;US25459W4583;18.0;94.45;2.59;0.00;1'697.51;USD;1'697.51;172'837.83;USD
31-03-2020 21:43:16;69847460;Verkauf;SOXL;DIREXION SEMICONDUCTOR BULL 3X;US25459W4583;10.0;94.45;1.44;0.00;943.06;USD;943.06;171'140.32;USD
31-03-2020 21:43:16;69847460;Verkauf;SOXL;DIREXION SEMICONDUCTOR BULL 3X;US25459W4583;100.0;94.45;14.36;0.00;9'430.64;USD;9'430.64;170'197.26;USD
31-03-2020 21:43:16;69847460;Verkauf;SOXL;DIREXION SEMICONDUCTOR BULL 3X;US25459W4583;100.0;94.45;104.36;0.00;9'340.64;USD;9'340.64;160'766.62;USD
31-03-2020 21:43:16;69847460;Verkauf;SOXL;DIREXION SEMICONDUCTOR BULL 3X;US25459W4583;100.0;94.45;14.36;0.00;9'430.64;USD;9'430.64;151'425.98;USD
31-03-2020 21:43:15;69847460;Verkauf;SOXL;DIREXION SEMICONDUCTOR BULL 3X;US25459W4583;100.0;94.45;14.37;0.00;9'430.63;USD;9'430.63;141'995.34;USD
31-03-2020 21:43:15;69847460;Verkauf;SOXL;DIREXION SEMICONDUCTOR BULL 3X;US25459W4583;100.0;94.45;14.37;0.00;9'430.63;USD;9'430.63;132'564.71;USD
31-03-2020 21:43:15;69847460;Verkauf;SOXL;DIREXION SEMICONDUCTOR BULL 3X;US25459W4583;100.0;94.47;14.36;0.00;9'432.64;USD;9'432.64;123'134.08;USD
31-03-2020 21:43:15;69847460;Verkauf;SOXL;DIREXION SEMICONDUCTOR BULL 3X;US25459W4583;100.0;94.49;64.37;0.00;9'384.63;USD;9'384.63;113'701.44;USD
31-03-2020 21:43:15;69847460;Verkauf;SOXL;DIREXION SEMICONDUCTOR BULL 3X;US25459W4583;100.0;94.50;14.36;0.00;9'435.64;USD;9'435.64;104'316.81;USD
31-03-2020 21:43:15;69847460;Verkauf;SOXL;DIREXION SEMICONDUCTOR BULL 3X;US25459W4583;100.0;94.49;49.38;0.00;9'399.62;USD;9'399.62;94'881.17;USD
31-03-2020 21:43:15;69847460;Verkauf;SOXL;DIREXION SEMICONDUCTOR BULL 3X;US25459W4583;172.0;94.49;79.71;0.00;16'172.57;USD;16'172.57;85'481.55;USD
31-03-2020 21:43:15;69847460;Verkauf;SOXL;DIREXION SEMICONDUCTOR BULL 3X;US25459W4583;100.0;94.49;54.37;0.00;9'394.63;USD;9'394.63;69'308.98;USD
31-03-2020 15:02:13;00000000;Dividende;SOXL;DIREXION SEMICONDUCTOR BULL 3X;US25459W4583;1.0;157.88;47.36;0.00;110.52;USD;110.52;59'914.35;USD
30-03-2020 20:34:37;00000000;Einzahlung;;;;1.0;450'000.00;0.00;0.00;450'000.00;CHF;450'000.00;453'488.31;CHF
25-03-2020 14:45:57;69571049;Kauf;SOXL;DIREXION SEMICONDUCTOR BULL 3X;US25459W4583;1500.0;95.97;485.93;0.00;-144'440.93;USD;-144'440.93;59'803.83;USD
24-03-2020 18:11:16;69514213;Berichtigung Börsengeb.;SOXL;DIREXION SEMICONDUCTOR BULL 3X;US25459W4583;1.0;-0.24;0.00;0.00;-0.24;USD;-0.24;204'244.76;USD
24-03-2020 18:11:07;69514213;Verkauf;SOXL;DIREXION SEMICONDUCTOR BULL 3X;US25459W4583;2000.0;86.75;613.84;0.00;172'886.16;USD;172'886.16;204'245.00;USD
19-03-2020 20:34:05;69321437;Kauf;SOXL;DIREXION SEMICONDUCTOR BULL 3X;US25459W4583;1020.0;74.13;203.42;0.00;-75'816.02;USD;-75'816.02;31'358.84;USD
19-03-2020 20:34:05;69321437;Kauf;SOXL;DIREXION SEMICONDUCTOR BULL 3X;US25459W4583;100.0;74.10;11.11;0.00;-7'421.11;USD;-7'421.11;107'174.86;USD
19-03-2020 20:34:04;69321437;Kauf;SOXL;DIREXION SEMICONDUCTOR BULL 3X;US25459W4583;80.0;74.07;8.89;0.00;-5'934.49;USD;-5'934.49;114'595.97;USD
19-03-2020 20:34:04;69321437;Kauf;SOXL;DIREXION SEMICONDUCTOR BULL 3X;US25459W4583;100.0;74.05;11.11;0.00;-7'416.11;USD;-7'416.11;120'530.46;USD
19-03-2020 20:34:04;69321437;Kauf;SOXL;DIREXION SEMICONDUCTOR BULL 3X;US25459W4583;100.0;74.05;61.11;0.00;-7'466.11;USD;-7'466.11;127'946.57;USD
19-03-2020 20:34:04;69321437;Kauf;SOXL;DIREXION SEMICONDUCTOR BULL 3X;US25459W4583;100.0;74.03;11.10;0.00;-7'414.10;USD;-7'414.10;135'412.68;USD
19-03-2020 20:34:04;69321437;Kauf;SOXL;DIREXION SEMICONDUCTOR BULL 3X;US25459W4583;100.0;74.06;46.11;0.00;-7'452.11;USD;-7'452.11;142'826.78;USD
19-03-2020 20:34:04;69321437;Kauf;SOXL;DIREXION SEMICONDUCTOR BULL 3X;US25459W4583;100.0;74.06;11.11;0.00;-7'417.11;USD;-7'417.11;150'278.89;USD
19-03-2020 20:34:03;69321437;Kauf;SOXL;DIREXION SEMICONDUCTOR BULL 3X;US25459W4583;100.0;74.05;56.11;0.00;-7'461.11;USD;-7'461.11;157'696.00;USD
19-03-2020 20:34:03;69321437;Kauf;SOXL;DIREXION SEMICONDUCTOR BULL 3X;US25459W4583;100.0;74.05;21.10;0.00;-7'426.10;USD;-7'426.10;165'157.11;USD
19-03-2020 20:34:03;69321437;Kauf;SOXL;DIREXION SEMICONDUCTOR BULL 3X;US25459W4583;100.0;74.04;51.11;0.00;-7'455.11;USD;-7'455.11;172'583.21;USD
19-03-2020 15:44:28;69304077;Berichtigung Börsengeb.;SOXL;DIREXION SEMICONDUCTOR BULL 3X;US25459W4583;1.0;-0.19;0.00;0.00;-0.19;USD;-0.19;180'038.32;USD
19-03-2020 15:44:21;69304077;Verkauf;SOXL;DIREXION SEMICONDUCTOR BULL 3X;US25459W4583;2000.0;66.91;473.50;0.00;133'346.50;USD;133'346.50;180'038.51;USD
18-03-2020 19:34:47;69260900;Kauf;SOXL;DIREXION SEMICONDUCTOR BULL 3X;US25459W4583;2.0;55.73;0.17;0.00;-111.63;USD;-111.63;46'692.01;USD
18-03-2020 19:34:47;69260900;Kauf;SOXL;DIREXION SEMICONDUCTOR BULL 3X;US25459W4583;100.0;55.73;8.35;0.00;-5'581.35;USD;-5'581.35;46'803.64;USD
18-03-2020 19:34:47;69260900;Kauf;SOXL;DIREXION SEMICONDUCTOR BULL 3X;US25459W4583;100.0;55.73;8.36;0.00;-5'581.36;USD;-5'581.36;52'384.99;USD
18-03-2020 19:34:47;69260900;Kauf;SOXL;DIREXION SEMICONDUCTOR BULL 3X;US25459W4583;100.0;55.73;98.36;0.00;-5'671.36;USD;-5'671.36;57'966.35;USD
18-03-2020 19:34:47;69260900;Kauf;SOXL;DIREXION SEMICONDUCTOR BULL 3X;US25459W4583;100.0;55.73;8.36;0.00;-5'581.36;USD;-5'581.36;63'637.71;USD
18-03-2020 19:34:47;69260900;Kauf;SOXL;DIREXION SEMICONDUCTOR BULL 3X;US25459W4583;100.0;55.73;8.36;0.00;-5'581.36;USD;-5'581.36;69'219.07;USD
18-03-2020 19:34:47;69260900;Kauf;SOXL;DIREXION SEMICONDUCTOR BULL 3X;US25459W4583;100.0;55.76;8.37;0.00;-5'584.37;USD;-5'584.37;74'800.43;USD
18-03-2020 19:34:46;69260900;Kauf;SOXL;DIREXION SEMICONDUCTOR BULL 3X;US25459W4583;100.0;55.76;8.36;0.00;-5'584.36;USD;-5'584.36;80'384.80;USD
18-03-2020 19:34:46;69260900;Kauf;SOXL;DIREXION SEMICONDUCTOR BULL 3X;US25459W4583;100.0;55.75;8.36;0.00;-5'583.36;USD;-5'583.36;85'969.16;USD
18-03-2020 19:34:46;69260900;Kauf;SOXL;DIREXION SEMICONDUCTOR BULL 3X;US25459W4583;100.0;55.75;8.37;0.00;-5'583.37;USD;-5'583.37;91'552.52;USD
18-03-2020 19:34:46;69260900;Kauf;SOXL;DIREXION SEMICONDUCTOR BULL 3X;US25459W4583;100.0;55.76;8.36;0.00;-5'584.36;USD;-5'584.36;97'135.89;USD
18-03-2020 19:34:46;69260900;Kauf;SOXL;DIREXION SEMICONDUCTOR BULL 3X;US25459W4583;100.0;55.67;8.35;0.00;-5'575.35;USD;-5'575.35;102'720.25;USD
18-03-2020 19:34:46;69260900;Kauf;SOXL;DIREXION SEMICONDUCTOR BULL 3X;US25459W4583;100.0;55.75;58.36;0.00;-5'633.36;USD;-5'633.36;108'295.60;USD
18-03-2020 19:34:46;69260900;Kauf;SOXL;DIREXION SEMICONDUCTOR BULL 3X;US25459W4583;100.0;55.75;8.37;0.00;-5'583.37;USD;-5'583.37;113'928.96;USD
18-03-2020 19:34:45;69260900;Kauf;SOXL;DIREXION SEMICONDUCTOR BULL 3X;US25459W4583;100.0;55.74;8.36;0.00;-5'582.36;USD;-5'582.36;119'512.33;USD
18-03-2020 19:34:45;69260900;Kauf;SOXL;DIREXION SEMICONDUCTOR BULL 3X;US25459W4583;100.0;55.74;43.36;0.00;-5'617.36;USD;-5'617.36;125'094.69;USD
18-03-2020 19:34:45;69260900;Kauf;SOXL;DIREXION SEMICONDUCTOR BULL 3X;US25459W4583;98.0;55.68;8.18;0.00;-5'464.82;USD;-5'464.82;130'712.05;USD
18-03-2020 19:34:45;69260900;Kauf;SOXL;DIREXION SEMICONDUCTOR BULL 3X;US25459W4583;100.0;55.68;10.50;0.00;-5'578.50;USD;-5'578.50;136'176.87;USD
18-03-2020 19:34:45;69260900;Kauf;SOXL;DIREXION SEMICONDUCTOR BULL 3X;US25459W4583;100.0;55.68;8.36;0.00;-5'576.36;USD;-5'576.36;141'755.37;USD
18-03-2020 19:34:45;69260900;Kauf;SOXL;DIREXION SEMICONDUCTOR BULL 3X;US25459W4583;100.0;55.68;8.35;0.00;-5'576.35;USD;-5'576.35;147'331.73;USD
18-03-2020 19:34:45;69260900;Kauf;SOXL;DIREXION SEMICONDUCTOR BULL 3X;US25459W4583;100.0;55.68;8.35;0.00;-5'576.35;USD;-5'576.35;152'908.08;USD
08-03-2020 06:55:40;00000000;Auszahlung;;;;1.0;20'000.00;0.00;0.00;-20'000.00;USD;-20'000.00;158'484.43;USD
08-03-2020 06:39:39;00000000;Auszahlung;;;;1.0;20'000.00;0.00;0.00;-20'000.00;USD;-20'000.00;178'484.43;USD
20-02-2020 14:45:13;00000000;Auszahlung;;;;1.0;25'000.00;0.00;0.00;-25'000.00;USD;-25'000.00;198'484.43;USD
20-02-2020 14:44:24;00000000;Auszahlung;;;;1.0;25'000.00;0.00;0.00;-25'000.00;USD;-25'000.00;223'484.43;USD
20-02-2020 13:24:36;00000000;Einzahlung;;;;1.0;20'000.00;0.00;0.00;20'000.00;USD;20'000.00;248'484.43;USD
10-01-2020 11:20:10;00000000;Bonusprogramm;;;;1.0;592.06;0.00;0.00;592.06;CHF;592.06;3'488.31;CHF
02-01-2020 11:33:03;00000000;Jahresgebühr;;;;1.0;90.00;0.00;0.00;-90.00;CHF;-90.00;2'896.25;CHF
12-12-2019 08:56:15;00000000;Dividende;AMAT;APPLIED MATERIAL ORD;US0382221051;1.0;126.00;37.80;0.00;88.20;USD;88.20;228'484.43;USD
20-11-2019 19:44:20;66351243;Verkauf;AMAT;APPLIED MATERIAL ORD;US0382221051;500.0;59.40;135.17;0.00;29'564.83;USD;29'564.83;228'396.23;USD
20-11-2019 19:44:20;66351243;Verkauf;AMAT;APPLIED MATERIAL ORD;US0382221051;100.0;59.41;49.03;0.00;5'891.97;USD;5'891.97;198'831.40;USD
20-11-2019 19:44:01;66351242;Verkauf;TSM;TAIWAN SEMICONDUCTOR MNFTG ADR;US8740391003;800.0;53.36;194.91;0.00;42'493.09;USD;42'493.09;192'939.43;USD
20-11-2019 19:41:17;66351222;Verkauf;NVDA;NVIDIA ORD;US67066G1040;200.0;209.63;193.76;0.00;41'732.24;USD;41'732.24;150'446.34;USD
20-11-2019 19:41:04;66351229;Verkauf;SWKS;SKYWORKS SOLUTIONS ORD;US83088M1027;100.0;96.14;49.62;0.00;9'564.38;USD;9'564.38;108'714.10;USD
20-11-2019 19:41:04;66351229;Verkauf;SWKS;SKYWORKS SOLUTIONS ORD;US83088M1027;300.0;96.14;138.86;0.00;28'703.14;USD;28'703.14;99'149.72;USD
18-11-2019 21:35:26;66314741;Verkauf;SOXL;DIREXION SEMICONDUCTOR BULL 3X;US25459W4583;250.0;231.26;267.92;0.00;57'547.08;USD;57'547.08;70'446.58;USD
07-11-2019 17:27:48;66158058;Kauf;SOXL;DIREXION SEMICONDUCTOR BULL 3X;US25459W4583;250.0;231.97;266.99;0.00;-58'259.49;USD;-58'259.49;12'899.50;USD
07-11-2019 15:30:12;66150936;Verkauf;MTW;MANITOWOC ORD;US5635714059;900.0;13.75;53.82;0.00;12'321.18;USD;12'321.18;71'158.99;USD
07-11-2019 15:30:06;66150936;Verkauf;MTW;MANITOWOC ORD;US5635714059;99.0;13.75;2.07;0.00;1'359.18;USD;1'359.18;58'837.81;USD
07-11-2019 15:30:06;66150936;Verkauf;MTW;MANITOWOC ORD;US5635714059;140.0;13.75;2.93;0.00;1'922.07;USD;1'922.07;57'478.63;USD
07-11-2019 15:30:06;66150936;Verkauf;MTW;MANITOWOC ORD;US5635714059;888.0;13.75;63.56;0.00;12'146.44;USD;12'146.44;55'556.56;USD
07-11-2019 15:30:05;66150936;Verkauf;MTW;MANITOWOC ORD;US5635714059;28.0;13.75;0.59;0.00;384.41;USD;384.41;43'410.12;USD
07-11-2019 15:30:05;66150936;Verkauf;MTW;MANITOWOC ORD;US5635714059;100.0;13.75;2.09;0.00;1'372.91;USD;1'372.91;43'025.71;USD
07-11-2019 15:30:05;66150936;Verkauf;MTW;MANITOWOC ORD;US5635714059;70.0;13.75;1.47;0.00;961.03;USD;961.03;41'652.80;USD
07-11-2019 15:30:05;66150936;Verkauf;MTW;MANITOWOC ORD;US5635714059;7.0;13.75;0.14;0.00;96.11;USD;96.11;40'691.77;USD
07-11-2019 15:30:05;66150936;Verkauf;MTW;MANITOWOC ORD;US5635714059;127.0;13.75;12.66;0.00;1'733.59;USD;1'733.59;40'595.66;USD
07-11-2019 15:30:05;66150936;Verkauf;MTW;MANITOWOC ORD;US5635714059;143.0;13.75;2.99;0.00;1'963.26;USD;1'963.26;38'862.07;USD
07-11-2019 15:30:05;66150936;Verkauf;MTW;MANITOWOC ORD;US5635714059;498.0;13.75;50.41;0.00;6'797.09;USD;6'797.09;36'898.81;USD
04-11-2019 15:30:28;66083074;Kauf;MTW;MANITOWOC ORD;US5635714059;1150.0;13.55;58.38;0.00;-15'640.88;USD;-15'640.88;30'101.72;USD
04-11-2019 15:30:24;66083053;Kauf;NVDA;NVIDIA ORD;US67066G1040;200.0;206.00;191.80;0.00;-41'391.80;USD;-41'391.80;45'742.60;USD
04-11-2019 15:30:23;66083041;Kauf;SWKS;SKYWORKS SOLUTIONS ORD;US83088M1027;400.0;99.14;189.48;0.00;-39'845.48;USD;-39'845.48;87'134.40;USD
04-11-2019 15:30:20;66083090;Kauf;AMAT;APPLIED MATERIAL ORD;US0382221051;600.0;56.02;180.42;0.00;-33'792.42;USD;-33'792.42;126'979.88;USD
04-11-2019 15:30:11;66083074;Kauf;MTW;MANITOWOC ORD;US5635714059;58.0;13.55;1.18;0.00;-787.08;USD;-787.08;160'772.30;USD
04-11-2019 15:30:11;66083074;Kauf;MTW;MANITOWOC ORD;US5635714059;80.0;13.55;1.62;0.00;-1'085.62;USD;-1'085.62;161'559.38;USD
04-11-2019 15:30:10;66083074;Kauf;MTW;MANITOWOC ORD;US5635714059;80.0;13.55;1.63;0.00;-1'085.63;USD;-1'085.63;162'645.00;USD
04-11-2019 15:30:10;66083074;Kauf;MTW;MANITOWOC ORD;US5635714059;602.0;13.55;57.24;0.00;-8'214.34;USD;-8'214.34;163'730.63;USD
04-11-2019 15:30:10;66083074;Kauf;MTW;MANITOWOC ORD;US5635714059;287.0;13.55;5.83;0.00;-3'894.68;USD;-3'894.68;171'944.97;USD
04-11-2019 15:30:10;66083074;Kauf;MTW;MANITOWOC ORD;US5635714059;525.0;13.55;25.67;0.00;-7'139.42;USD;-7'139.42;175'839.65;USD
04-11-2019 15:30:10;66083074;Kauf;MTW;MANITOWOC ORD;US5635714059;100.0;13.55;2.03;0.00;-1'357.03;USD;-1'357.03;182'979.07;USD
04-11-2019 15:30:10;66083074;Kauf;MTW;MANITOWOC ORD;US5635714059;2.0;13.55;0.04;0.00;-27.14;USD;-27.14;184'336.10;USD
04-11-2019 15:30:10;66083074;Kauf;MTW;MANITOWOC ORD;US5635714059;100.0;13.55;12.03;0.00;-1'367.03;USD;-1'367.03;184'363.24;USD
04-11-2019 15:30:10;66083074;Kauf;MTW;MANITOWOC ORD;US5635714059;1.0;13.55;0.03;0.00;-13.58;USD;-13.58;185'730.27;USD
04-11-2019 15:30:09;66083074;Kauf;MTW;MANITOWOC ORD;US5635714059;15.0;13.55;25.30;0.00;-228.55;USD;-228.55;185'743.85;USD
04-11-2019 15:30:06;66083034;Kauf;TSM;TAIWAN SEMICONDUCTOR MNFTG ADR;US8740391003;38.0;53.55;3.05;0.00;-2'037.95;USD;-2'037.95;185'972.40;USD
04-11-2019 15:30:05;66083034;Kauf;TSM;TAIWAN SEMICONDUCTOR MNFTG ADR;US8740391003;400.0;53.55;92.13;0.00;-21'512.13;USD;-21'512.13;188'010.35;USD
04-11-2019 15:30:05;66083034;Kauf;TSM;TAIWAN SEMICONDUCTOR MNFTG ADR;US8740391003;300.0;53.55;59.10;0.00;-16'124.10;USD;-16'124.10;209'522.48;USD
04-11-2019 15:30:05;66083034;Kauf;TSM;TAIWAN SEMICONDUCTOR MNFTG ADR;US8740391003;62.0;53.55;39.98;0.00;-3'360.08;USD;-3'360.08;225'646.58;USD
31-10-2019 16:52:08;66060040;Verkauf;AMAT;APPLIED MATERIAL ORD;US0382221051;700.0;54.17;147.67;0.00;37'771.33;USD;37'771.33;229'006.66;USD
31-10-2019 16:52:08;66060040;Verkauf;AMAT;APPLIED MATERIAL ORD;US0382221051;100.0;54.18;48.24;0.00;5'369.76;USD;5'369.76;191'235.33;USD
31-10-2019 16:51:53;66060033;Verkauf;TSM;TAIWAN SEMICONDUCTOR MNFTG ADR;US8740391003;1300.0;51.47;281.76;0.00;66'629.24;USD;66'629.24;185'865.57;USD
31-10-2019 16:51:39;66060004;Verkauf;SWKS;SKYWORKS SOLUTIONS ORD;US83088M1027;600.0;90.10;192.21;0.00;53'867.79;USD;53'867.79;119'236.33;USD
31-10-2019 16:51:39;66060004;Verkauf;SWKS;SKYWORKS SOLUTIONS ORD;US83088M1027;100.0;90.10;43.69;0.00;8'966.31;USD;8'966.31;65'368.54;USD
31-10-2019 16:51:39;66060004;Verkauf;SWKS;SKYWORKS SOLUTIONS ORD;US83088M1027;100.0;90.10;53.71;0.00;8'956.29;USD;8'956.29;56'402.23;USD
31-10-2019 16:51:29;66060014;Verkauf;NVDA;NVIDIA ORD;US67066G1040;150.0;200.71;175.78;0.00;29'930.72;USD;29'930.72;47'445.94;USD
31-10-2019 16:51:01;66059980;Verkauf;MTW;MANITOWOC ORD;US5635714059;1400.0;12.58;96.78;0.00;17'515.22;USD;17'515.22;17'515.22;USD
25-10-2019 22:16:12;00000000;Fx-Gutschrift Comp.;;;;1.0;8'951.60;0.00;0.00;8'951.60;USD;8'951.60;0.00;USD
25-10-2019 22:16:12;00000000;Fx-Belastung Comp.;;;;1.0;9'013.75;0.00;0.00;-9'013.75;CHF;-9'013.75;2'986.25;CHF
25-10-2019 20:13:29;65974102;Kauf;MTW;MANITOWOC ORD;US5635714059;100.0;13.05;1.95;0.00;-1'306.95;USD;-1'306.95;-8'951.60;USD
25-10-2019 20:13:29;65974102;Kauf;MTW;MANITOWOC ORD;US5635714059;200.0;13.0499;23.92;0.00;-2'633.90;USD;-2'633.90;-7'644.65;USD
25-10-2019 20:13:29;65974102;Kauf;MTW;MANITOWOC ORD;US5635714059;300.0;13.0499;5.87;0.00;-3'920.84;USD;-3'920.84;-5'010.75;USD
25-10-2019 20:13:29;65974102;Kauf;MTW;MANITOWOC ORD;US5635714059;200.0;13.04;13.91;0.00;-2'621.91;USD;-2'621.91;-1'089.91;USD
25-10-2019 20:13:29;65974102;Kauf;MTW;MANITOWOC ORD;US5635714059;100.0;13.04;1.96;0.00;-1'305.96;USD;-1'305.96;1'532.00;USD
25-10-2019 20:13:29;65974102;Kauf;MTW;MANITOWOC ORD;US5635714059;200.0;13.04;8.91;0.00;-2'616.91;USD;-2'616.91;2'837.96;USD
25-10-2019 20:13:29;65974102;Kauf;MTW;MANITOWOC ORD;US5635714059;100.0;13.04;1.96;0.00;-1'305.96;USD;-1'305.96;5'454.87;USD
25-10-2019 20:13:28;65974102;Kauf;MTW;MANITOWOC ORD;US5635714059;100.0;13.04;1.95;0.00;-1'305.95;USD;-1'305.95;6'760.83;USD
25-10-2019 20:13:28;65974102;Kauf;MTW;MANITOWOC ORD;US5635714059;100.0;13.04;36.96;0.00;-1'340.96;USD;-1'340.96;8'066.78;USD
25-10-2019 20:08:54;00000000;Einzahlung;;;;1.0;12'000.00;0.00;0.00;12'000.00;CHF;12'000.00;12'000.00;CHF
22-10-2019 15:30:12;65910492;Kauf;AMAT;APPLIED MATERIAL ORD;US0382221051;800.0;52.65;193.18;0.00;-42'313.18;USD;-42'313.18;9'407.74;USD
22-10-2019 08:00:32;65900593;Berichtigung Börsengeb.;TKY;TOKYO ELECTRON ORD;JP3571400005;1.0;1.60;0.00;0.00;1.43;EUR;1.60;51'720.92;USD
22-10-2019 08:00:30;65900593;Verkauf;TKY;TOKYO ELECTRON ORD;JP3571400005;200.0;177.00;224.87;0.00;35'175.12;EUR;38'743.32;51'719.32;USD
18-10-2019 19:37:38;65879671;Kauf;SWKS;SKYWORKS SOLUTIONS ORD;US83088M1027;400.0;87.93;182.76;0.00;-35'354.76;USD;-35'354.76;12'976.00;USD
18-10-2019 19:36:16;65879651;Verkauf;TSM;TAIWAN SEMICONDUCTOR MNFTG ADR;US8740391003;800.0;49.37;190.06;0.00;39'305.94;USD;39'305.94;48'330.76;USD
16-10-2019 22:16:14;00000000;Fx-Gutschrift Comp.;;;;1.0;1'374.09;0.00;0.00;1'374.09;CHF;1'374.09;0.00;CHF
16-10-2019 22:16:14;00000000;Fx-Belastung Comp.;;;;1.0;1'398.64;0.00;0.00;-1'398.64;USD;-1'398.64;9'024.82;USD
16-10-2019 15:59:30;65837529;Kauf;SWKS;SKYWORKS SOLUTIONS ORD;US83088M1027;400.0;86.31;181.79;0.00;-34'705.79;USD;-35'009.15;-1'374.09;CHF
16-10-2019 15:58:39;65837488;Verkauf;ALGN;ALIGN TECHNOLOGY ORD;US0162551016;200.0;208.68;193.46;0.00;41'542.53;USD;40'873.45;33'635.06;CHF
16-10-2019 15:51:37;65837289;Kauf;NVDA;NVIDIA ORD;US67066G1040;150.0;197.69;139.48;0.00;-29'793.02;USD;-30'059.85;-7'238.39;CHF
15-10-2019 19:55:31;65825237;Kauf;ALGN;ALIGN TECHNOLOGY ORD;US0162551016;200.0;208.56;192.57;0.00;-41'904.56;USD;-42'361.95;22'821.46;CHF
15-10-2019 19:51:28;00000000;Einzahlung;;;;1.0;40'000.00;0.00;0.00;40'000.00;CHF;40'000.00;65'183.41;CHF
11-10-2019 11:51:12;65778492;Kauf;TKY;TOKYO ELECTRON ORD;JP3571400005;200.0;183.00;206.86;0.00;-36'806.91;EUR;-40'963.40;25'183.41;CHF
11-10-2019 11:46:48;00000000;Einzahlung;;;;1.0;50'000.00;0.00;0.00;50'000.00;CHF;50'000.00;66'146.81;CHF
08-10-2019 15:31:50;65717092;Kauf;TSM;TAIWAN SEMICONDUCTOR MNFTG ADR;US8740391003;1040.0;48.20;160.17;0.00;-50'288.17;USD;-50'468.50;16'146.81;CHF
08-10-2019 15:31:49;65717092;Kauf;TSM;TAIWAN SEMICONDUCTOR MNFTG ADR;US8740391003;560.0;48.20;135.49;0.00;-27'127.54;USD;-27'224.95;66'615.31;CHF
08-10-2019 09:12:00;00000000;Einzahlung;;;;1.0;80'000.00;0.00;0.00;80'000.00;CHF;80'000.00;93'840.26;CHF
07-10-2019 15:30:49;65632958;Kauf;TSM;TAIWAN SEMICONDUCTOR MNFTG ADR;US8740391003;500.0;47.79;130.84;0.00;-24'025.84;USD;-24'025.84;10'423.46;USD
02-10-2019 20:45:48;65597047;Verkauf;GME;GAMESTOP CL A ORD;US36467W1099;2200.0;5.32;67.80;0.00;11'636.20;USD;11'636.20;34'449.30;USD
02-10-2019 20:45:19;65597050;Verkauf;WMT;WALMART ORD;US9311421039;100.0;116.44;67.71;0.00;11'576.29;USD;11'576.29;22'813.10;USD
02-10-2019 20:44:49;65597044;Verkauf;AMD;ADVANCED MICRO DEVICES ORD;US0079031078;400.0;28.26;67.19;0.00;11'236.81;USD;11'236.81;11'236.81;USD
01-10-2019 16:38:51;65555716;Kauf;GME;GAMESTOP CL A ORD;US36467W1099;291.0;5.55;12.38;0.00;-1'627.43;USD;-1'643.50;13'840.26;CHF
01-10-2019 16:38:51;65555716;Kauf;GME;GAMESTOP CL A ORD;US36467W1099;1400.0;5.55;16.61;0.00;-7'786.63;USD;-7'863.50;15'483.76;CHF
01-10-2019 16:38:40;65555716;Kauf;GME;GAMESTOP CL A ORD;US36467W1099;100.0;5.55;0.84;0.00;-555.86;USD;-561.35;23'347.26;CHF
01-10-2019 16:28:40;65555716;Kauf;GME;GAMESTOP CL A ORD;US36467W1099;209.0;5.55;36.74;0.00;-1'196.69;USD;-1'209.85;23'908.61;CHF
01-10-2019 15:30:15;65555897;Kauf;WMT;WALMART ORD;US9311421039;100.0;118.85;63.29;0.00;-11'948.30;USD;-12'099.80;25'118.46;CHF
01-10-2019 15:30:09;65555899;Kauf;AMD;ADVANCED MICRO DEVICES ORD;US0079031078;400.0;29.05;17.43;0.00;-11'637.42;USD;-11'785.05;37'218.26;CHF
26-09-2019 22:16:14;00000000;Fx-Gutschrift Comp.;;;;1.0;1'061.59;0.00;0.00;1'061.59;USD;1'061.59;0.00;USD
26-09-2019 22:16:14;00000000;Fx-Belastung Comp.;;;;1.0;1'067.96;0.00;0.00;-1'067.96;CHF;-1'067.96;49'003.31;CHF
26-09-2019 20:40:29;65509113;Kauf;GME;GAMESTOP CL A ORD;US36467W1099;200.0;5.30;1.59;0.00;-1'061.59;USD;-1'061.59;-1'061.59;USD
26-09-2019 19:14:47;00000000;Einzahlung;;;;1.0;50'000.00;0.00;0.00;50'000.00;CHF;50'000.00;50'071.27;CHF
05-06-2019 09:40:33;63829215;Titeleingang;ZUEHLKE TECHNOL;ZUEHLKE TECHNOL-NAMENAKT;CH0011741458;51.0;2'128.90;0.00;0.00;-;CHF;-;0.00;CHF
03-01-2019 11:14:22;00000000;Jahresgebühr;;;;1.0;90.00;0.00;0.00;-90.00;CHF;-90.00;71.27;CHF
01-01-2019 10:41:02;00000000;Zins;;;;1.0;1.48;0.00;0.00;-1.48;CHF;-1.48;161.27;CHF
07-12-2018 08:45:33;61260414;Titeleingang;ZUEHLKE TECHNOL;ZUEHLKE TECHNOL-NAMENAKT;CH0011741458;44.0;2'128.90;0.00;0.00;-;CHF;-;0.00;CHF
04-12-2018 08:34:41;00000000;Einzahlung;;;;1.0;162.75;0.00;0.00;162.75;CHF;162.75;162.75;CHF
06-04-2018 16:10:12;57618622;Titeleingang;ZUEHLKE TECHNOL;ZUEHLKE TECHNOL-NAMENAKT;CH0011741458;48.0;0.01;0.00;0.00;-;CHF;-;0.00;CHF
06-03-2018 11:35:39;00000000;Einzahlung;;;;1.0;90.57;0.00;0.00;90.57;CHF;90.57;0.00;CHF
28-02-2018 15:05:14;56996375;Titeleingang;ZUEHLKE TECHNOL;ZUEHLKE TECHNOL-NAMENAKT;CH0011741458;100.0;0.01;0.00;0.00;-;CHF;-;0.00;CHF
03-01-2018 08:07:07;00000000;Jahresgebühr;;;;1.0;90.00;0.00;0.00;-90.00;CHF;-90.00;-90.57;CHF
30-12-2017 13:41:49;00000000;Zins;;;;1.0;0.57;0.00;0.00;-0.57;CHF;-0.57;-0.57;CHF
27-01-2017 16:56:45;00000000;Einzahlung;;;;1.0;90.00;0.00;0.00;90.00;CHF;90.00;0.00;CHF
05-01-2017 14:12:42;00000000;Jahresgebühr;;;;1.0;90.00;0.00;0.00;-90.00;CHF;-90.00;-90.00;CHF
